信息没有保存，是否确认关闭？=Info has not been saved, confirm to close?
客户=Customer 
供应商=Vendor 
销售单=Sales 
采购单=Purchase 
退货单=Returns 
库存=Inventory 
费用收入=Entries 
报表=Reports
商户设置=Settings 
员工管理=Staff 
业务日志=Event Log 
商业版=BIZGO Prime Version 
总览=Overview
仓管人员=Warehouse staff
送货单=Delivery Order
收货单=Receipt Order
采购人员=Purchaser
老板=Administrator
业务员=Staff
想要体验一下秒账功能吗？点击右上角退出按钮 ，去登录界面，直接点击登录体验账号，去体验一下吧=To try BIZGO Prime, go to Demo Account on the login page.
知道了=OK
操作太频繁=Operation too frequent 
的=of
非法=Invalid
编辑客户=Edit customer
编辑供应商=Edit vendor
请选择供应商=Select vendor
供应商名称=Vendor Name
请选择客户=Select customer
客户名称=Customer Name
年=Year
月=Month
日=Day
合同金额=Contract Amount
已送货=Goods Delivered
未收款=Receivables
已收款=Payment Received
已收货=Goods Received
未付款=Payables
已付款=Paid Amount
新增失败=Addition failed
未使用=Not used
已过期=Expired
已使用=Used
秒账专用=Exclusive to BIZGO Prime
使用条件：最大抵扣订单总额的50=Condition: The maximum deductible amount is $50 
, 超过订单总额50=and it exceeds  
的金额作废=which will be invalid.
有效时间:=Time: 
专用=Exclusive
使用条件：最多抵扣订单总额的100=Condition: The maximum deductible amount is $100 
，超过订单总额100=, and it exceeds 
至=to
下载=Download
个人=Personal
已上传=Uploaded
删除=Delete
秒账=BIZGO Prime
缓存失效，请重新登录=Timeout session, please re-login. 
当前页:=Current
每页显示:=Display 
共=Total
下一页=Next page
上一页=Last page
正序=Ascending
倒序=Descending
清除排序=Reset 
暂无数据=No data 
加载中=Loading
星期日=Sun
星期一=Mon
星期二=Tue
星期三=Wed
星期四=Thurs
星期五=Fri
星期六=Sat
周日=Sun
周一=on Mon
周二=on Tue
周三=on Wed
周四=on Thurs
周五=on Fri
周六=on Sat
1月=Jan
2月=Feb
3月=Mar
4月=Apr
5月=May
6月=Jun
7月=Jul
8月=Aug
9月=Sep
10月=Oct
11月=Nov
12月=Dec
网络异常，请稍后重试=Connection error, try again later.
出错了=Error
错误码：=Error:
外箱尺寸=Carton Size
重量=Wt.
单价=Unit Price
每箱数量=Qty per Carton
总箱数=Total Carton
总数量=Total Qty
库存数量=Stock Qty
未分类=Uncategorized
共{$1}条={$1} record(s) in total
条/页=/page
跳至=Go to
页=Page
今天=Today
清空=Clear
请选择时间=Select time
文件名不能为空=File name cannot be blank.
选择附件=Select attachment
开始上传=Upload
回调函数=Revert
一次只能导入一个文件=Can only import 1 file at a time.
文件数量不能超过100个=The maximum is 100 files. 
已过滤=Filtered
等待上传=Pending
导入成功=Uploaded
请输入附件名=Enter file name
确定要删除？=Confirm to delete?
网络出错，请检查网络设置=Internet error found. Check your connection.
需要购买才能使用哦=You need to purchase in order to use this function. 
文件大小不能大于=File size cannot exceed
文件数量不能超过5个=Maximum 5 files
文件格式不符=File format is not matched.
暂停上传=Pause
传入删除方法=Specify the delete method
更新人=Staff
备注=Remarks
更新时间=Time Updated
再次提交=Re-submit
提交理由=Reason
确定=Confirm
取消=Cancel
提交理由不能为空=Reasons cannot be empty. 
提交理由字数最大长度为200=Max length is 200 characters.
审批处理=Audit process
审批意见=Audit comment
审批通过=Approved
审批不通过=Rejected
审批意见不能为空=Audit comment field cannot be blank.
请选择=Select
全部=All
角=    
分=CENT 
零=ZERO  
壹=ONE
贰=TWO
叁=THREE
肆=FOUR
伍=FIVE
陆=SIX
柒=SEVEN
捌=EIGHT
玖=NINE
元=DOLLAR
万= ten thousand
亿=one hundred million
拾=TEN
佰=Hundred
仟=Thousand
欠=Due
(/零
整(/(零零$/,
零元/,
整$/,
零元整= Integer Value Zero Yuan
操作成功=Operation completed.
确定作废？=Confirm to void?
请输入=Enter
上传中=Uploading
导入持续进行中，您可以进行系统其他操作，导入不会中断=Importing in process. You can continue while importing your file. 
请选择需要打印的项=Select pages to be printed.
邮件=Email
收款=Payment received
付款=Paid
送货=Shipping
收货=Receiving
添加产品服务=Add item service
字数过长，系统已截取到1000位=Cannot exceed 1000 characters.
请点击扫码框然后进行扫码=Click the scanner before scanning. 
请点击条形码输入框然后进行扫码=Click to scan barcode.
停下这个操作，喝杯咖啡吧=Try again later.
新建供应商=Add vender
新建客户=Add customer
新建产品=New item
确定要取消？=Confirm to delete?
我的购买=Cart
请输入登录密码确认哦=Enter your user name and password.
确认=Confirm
算了=Cancel
请输入登录密码=Enter password
请输入密码=Enter password
密码长度应为6-20位=Password must be  6-20 characters
确认删除该单位=Confirm to delete unit
副单位=Sub-unit
换算比例=Conversion Rate
请选择或输入副单位=Please select or enter sub-unit
副单位1=Sub-unit 1
副单位2=Sub-unit 2
提示=Prompt
立即购买=Buy now
错误=Error
404:请求没有找到=Error 404: Request not found.
不=No
少=little
抱歉=Sorry
没有=do not have
哇哦=wow
错=wrong
失败=failed
最多=At most
只=only
需要=needs
请=Please
必须=must
凌晨好=Good morning
早上好=Good morning
上午好=Good morning
中午好=Good afternoon
下午好=Good afternoon
傍晚好=Good afternoon
晚上好=Good evening
夜里好=Good evening
您确定要进行此操作吗？=Confirm to proceed?
产品种类=Item Type
单位=Unit
重复=Repeat
采购=Purchase
一键收货=Quick Receiving
已收数量=Received Qty
本次收货=Current qty received
收货数量=Received Qty
销售=Sales
一键送货=Quick Delivery
已送数量=Qty Delivered
本次送货=Current qty delivered
送货数量=Qty Delivered 
退货=Returns
退货数量=Return Qty
调拨数量=Transfer Qty
单价=Unit Price
折后价=Price after discount
种类=Category
请输入或选择产品=Select or enter item
增加=Add
减少=Outflow
货号=Item No.    
客户货号=Customer Item No.
图片=Image
规格型号=Dimensions
颜色=Colour  
细码数量=Qty
细码匹数=Size(s)
损耗数量=Damaged Qty
单位=Unit 
已采购=Purchased
销售数量=Qty sold
折扣=Discount  
金额=Amount    
调出库当前数量=Outflow Qty
调入库当前数量=Inflow Qty
长=Length
体积:=Volume:
宽=Width
高=Height
体积=Volume
外箱尺寸(=Carton size (
备注=Remarks      
进价=Purchase Price  
成本=Cost
采购箱数=Carton Purchased
采购数量=Qty Purchased
单子=Order
总重量=Total Weight
主单位=Main Unit
后台总金额=Total Back-end Amount
成本总金额=Total Cost Amount
销售成本总金额=Total cost of sales
已收送货总金额=Total payment received 
待收送货总金额=Total delivery amount to be received
库存预警=Low Stock Alert
关联销售单详情=Related SO details
关联销售退货单详情=Related return details
单位数量=Unit Qty
单位已销售数量= Qty sold in units
单位本次销售数量=Current Qty sold in units
金额公式=Amount Formula
库存数量公式=Inventory Formula
定位=Position
格子专用= Grid for exclusive use
销售单金额大于1万亿，系统暂不支持=The system does not support as SO amount exceeds $1 trillion.
第=The
行公式使用错误，被除数不能为0=Formula error as dividend cannot be 0.
行请重新选择产品=Select the item again
行产品只能是下拉框里面的=The item can only be from the drop-down list
第{$1}行{$2}数量不能为0=The {$2} Qty in row {$1} cannot be 0.
第{$1}行单价不能为负数=The unit price in row {$1} cannot be negative.
第{$1}行请选择供应商=Select the vendor in row {$1}.
编号=No.
合计=Total
操作=Actions
复制=Copy
新增=Add
本次采购=Current purchase
请先选择产品=Select the item
产品存在，但是被禁用，请开启后使用=The item has been suspended. To use, enable it on the Item Tab. 
被禁用产品=Disabled item
新产品=New item
供应商存在，但是被禁用，请开启后使用=The vendor has been suspended. To use, enable it on the Vendor Tab. 
被禁用供应商=Suspended Vendor
新供应商=New Vendor
请去产品界面新增产品=Go to Item Tab to add
供应商=Vendor
已被禁用，请开启后使用=It is suspended. To use, enable it. 
请去产品界面新增规格=Add new dimensions in the Item Tab
请去产品界面新增颜色=Add new colour in the Item Tab
货号不存在，请先去选择产品=The Order No. does not exist. Select the item first.
产品=Item 
已被禁用，请开启后使用=It is suspended. To use, enable it.
提示：=Prompt:
，数量：1=, Qty:1
扫码的条码没有对应的产品，是否需要新增产品？=The barcode does not exist. Do you want to add new item instead?
请选择产品=Select the item
数量=Quantity
颜色描述=Description
颜色描述不能为空=Colour description cannot be blank
检查到您修改的颜色，已经被订单使用，是否继续修改，绑定的单据会一起改变=The colour you modified has been used in the orders. If you wish to proceed, all the related orders with this colour will be changed. 
继续=Continue
(/规格/:(/Dimension/
颜色=Colour
温馨提示：=Tips:
再考虑一下=Cancel
图片上传失败，请重新上传=Image upload failed, please try again. 
请选择上传图片=Click to insert image.
p格式图片=pFormat Image
规格描述不能为空=Dimension description cannot be blank
规格描述=Dimension Description
检查到您修改的规格型号，已经被订单使用，是否继续修改，订单和库存该规格型号文字会同步修改=The dimension you modified has been used in the orders. If you wish to proceed, all the related orders with this dimension will be changed. 
(/颜色/=(/colour/
规格=Dimensions
细码个数不能超过20个哦=Metres qty cannot exceed 20.
单个细码数值不能超过1000万，请删除后重试=Each metre cannot exceed 10 million. Delete and try again. 
单个细码数值不能超过1000万=The value cannot exceed $10 million.
点击旋转=Click to rotate
双击即可查看大图哦=Double click to view image
第{$1}行没有选择规格型号,确认保存吗？=Dimension is not selected in row {$1}, confirm to save?
第{$1}行没有选择颜色,确认保存吗？=Colour is not selected in row {$1}, confirm to save?
读取库存失败=Failed to retrieve inventory
请先为该产品添加颜色或规格=Add colour or dimensions for the item first
请先选择一个产品=Select an item first
条 共=Total
用户名密码不能为空=Password cannot be blank. 
用户名不能为空=Username cannot be blank
密码不能为空=Password cannot be blank
密码不能小于6位=Password length cannot be less than 6
，您当前浏览器版本过低，建议您升级浏览器=, your current browser version is too old. We recommend that you upgrade your browser.
360浏览器=360 Browser
谷歌浏览器=Google Chrome Browser
公司设置=Company setting
用户管理=User management
科目设置=Account setting
新增产品服务=Add new item service
产品服务=Item service
付款单=Receipt
报价单=Quotation 
收款单=Receipt
报销=Reimbursement
其他收入=Other income
费用支出=Expenses
凭证=Certificate
账簿=Account book
银行对账=Bank Reconcillations
期末结转=Carry-over
结账=Payment
现金=Cash
支付宝=Apple Pay
微信支付=Google Pay
银行转账=Bank Transfer
刷卡=Credit Card
支票=Cheque
期初库存=Opening Stock
售价=Sales Price
进价=Purchase Price
常用=Commonly used
是否禁用=Status
抱歉，不允许删除哦=You are not allowed to delete it.
该数据已有销售或者采购业务数据，如果继续删除，原业务数据编辑将不再保留所有相关信息，是否继续？=The data contains business data. If you proceed to delete, the information will not be retained. Continue?
确认删除？=Confirm to delete?
下载地址不能为空=Download address cannot be blank
下载失败，文件内容为空=Download failed as file is empty.
网络连接失败=Internet connection error
下载停止=Download paused
未定义=Undefined
在线客服=Online service
覆盖=Cover
修改重新上传=Edit and reupload 
跳过=Skip
已导入=Imported
行数据,文件剩余数据不再导入=For row data, data will not be imported.
导入完成=Import completed.
关闭=Close
文件校验中=Verifying file
关闭窗口将会停止导入，是否要关闭？=Import will stop if the window is closed. Confirm to close? 
连接发生错误=Connection error
连接关闭=Connection closed
日期:=Date:
收入:=Income:
支出:=Expenses:
收支差:=Income and Expense Balance
收支一览表=Annual Income and Expense Report
今日=Today
昨日=Yesterday
金额=Amount
收入=Income
支出=Expenses
收支差:=Income and Expenses Balance: 
收支差:=Income and Expenses Balance:
利润=Profit:
查看客户=View customer
电话=Contact No.
未收款项=Receivables
已收款项=Payment Received
新增销售单=Create new SO
新建销售单=New SO
查看供应商=View vendor
未付款项=Payables
已付款项=Amount paid
新建采购单=New PO
账户管理=Accounts Managment
暂无新消息=No info
消息推送=Push Notification 
全部忽略=Ignore all
系统通知=Notification
收款提醒=Payment Collection Reminder
付款提醒=Payment Reminder
送货提醒=Delivery Reminder
收货提醒=Goods Receipt Reminder
订单转换=Smart Conversion
残忍驳回=Reject
顺利通过=Accept
抱歉，您的账号没有权限，请联系管理员分配角色=You do not have the permission. Contact the administrator to modify roles. 
仓管=Warehouse
送货提醒表=Delivery Reminder
一=Mon
二=Tues
三=Wed
四=Thurs
五=Fri
六=Sat
日 星期=Sun
订单历史=Order history
我的秒账=My Account
邮件历史=Email history
此销售单已被删除=This SO has been deleted.
此采购单已被删除=This PO has been deleted.
此费用收入已被删除=This income statement has been deleted.
此送货单已被删除=This delivery order has been deleted.
此收货单已被删除=This receipt order has been deleted.
此退货单已被删除=This return order has been deleted.
此客户已被删除=This customer has been deleted.
此供应商已被删除=This vendor has been deleted.
此产品已被删除=This item has been deleted.
产品=Item
收货提醒表=Goods Receipt Reminder
快捷开单已成功转换为正常订单=The order has been successfully converted to a SO.
余额不足=Insufficient balance
抱歉，您的余额不足，请先去=You do not have enough balance, go to
我的秒账=My BIZGO
界面充值，再点击通过哦，要不程序员就发不起工资啦=Top-up to proceed.
具体规则请看=Please see the specific rules
智能转换服务协议=Smart Conversion Service Agreement
抱歉，请先去选择=First select
，再新增地址=, then add in the new address.
确认删除吗？=Confirm to delete?
按钮指定错误=Button assignment error
单号不能为空哦=The Order No. cannot be blank.
请选择调出仓库=Select the warehouse to deliver items
请选择调入仓库=Select the warehouse to receive items
不能为空=Field cannot be blank.
不能有中文=Chinese is not allowed.
请输入大于等于0的数=Enter positive numbers
请输入或选择=Enter or select
请输入或选择供应商=Enter or select vendor
已有供应商=Existing vendor
新增供应商=Create new vendor
请选择收货地址=Select receiving address
电话号码格式错误=Incorrect contact no. error
单号只能为数字和字母和-的组合哦=The Order No. can only be a combination of alphanumeric and - characters.
不能小于采购日期=Cannot be earlier than the purchase date
订单详情不能为空=Order details cannot be blank.
确定删除未选中的产品？=Are you sure you want to delete unselected items?
请选择需要生成采购单的行=Select the row to generate PO
确定生成采购单？=Confirm to generate PO?
请输入供应商名或电话=Enter Vendors’(Vendor’s) name(s) or contact(s)
请输入或选择客户=Enter or select customer
选择冲销欠款，您填写的退款金额会冲销掉与此客户发生的业务欠款金额=By selecting this, your purchase refund amount will be used to offset payables. 
选择冲销欠款，您填写的退款金额会冲销掉与此供应商发生的业务欠款金额=By selecting this, your sales refund amount will be used to offset receivables.
请选择退货地址=Select return address
退货日期不能为空=Return date cannot be blank
退款金额不能为空=Return amount cannot be blank.
已有客户=Existing customers
客户存在，但是被禁用，请开启后使用=The customer has been suspended. To use, please enable the customer.
新增客户=Create new customer
确定生成采购退货单？=Confirm to generate a Purchase Return Order?
请选择送货地址=Select shipping address
不能小于销售日期=Cannot be earlier than the sales date
合同金额：=Sales amount
最多只能上传5张单据图片=Can only upload a maximum of 5 images
请上传一张图片或附件=Upload an image or attachment
文件和图片一起，不超过5张=The total no. of documents and images cannot be more than 5
确定智能转换，把快捷开单=Confirm to do smart conversion?
转换为销售合同？=Confirm to convert sales contract?
请先同意服务协议哦=Please agree to the Service Agreement first.
该订单被存为草稿，收款记录将不会被记录，请确认？=Order will be saved as a draft and it will not be recorded. Do you confirm?
编辑销售单=Edit SO
客户导入模板=Customer import template
请输入客户名或电话=Enter customer name or contact no.
启用=Active
禁用=Suspend
请输入客户分类名=Enter or select customer type
最近一周=Last Week
最近两周=Last 2 Weeks
最近三周=Last 3 Weeks
本月=Current Month
本季度=Current Quarter
本年=Current Year
编辑=Edit
新建报价单=Create new quotation
新建通用单据=Create new order
抱歉，此客户没有欠款，不需要收款=This customer has no receivables so payment collection is not required. 
客户被禁用=This customer has been suspended.
确认要删除吗？=Confirm to delete?
确定要禁用？=Confirm to suspend?
确定要启用？=Confirm to enable?
订单金额输入有误=Order amount entered has error 
收款金额输入有误=Receivables amount entered has error 
草稿=Draft
部分收款=Partially Received
全部收款=Fully Received
超收款=Overpayment
未退款=Pending
已退款=Refunded
冲销欠款=Offset Receivables
未送货=Pending
部分送货=Partially Delivered
全部送货=Fully Delivered
拒收=Refund
部分付款=Partially Paid
全部付款=Fully Paid
超付款=Overpayment
部分收货=Partially Received
全部收货=Fully Received
转账=Bank transfer
备用电话=Alt. Tel
传真=Website
邮箱=Email
单号=Order No.
日期=Date
(冲销欠款=(Offset Receivables 
收款状态=Receipt Status
送货状态=Delivery Status
订单编号=Order No.
收款日期=Receipt Date
收款金额=Receipt Amount
收款账户=Receipt Account
确定要删除吗？=Confirm to delete?
请选择或输入=Select or enter
销售单已经送货啦，检测到对应的采购单=The SO has been delivered and its corresponding PO is detected.
还没有收货，是否要同时对采购单收对应产品，相同数量的货品呢？=The items have not been received. Do you want to do receiving for its corresponding PO?
采购单号=PO No.
计划付款日期=Due Date
采购日期=Purchase Date
优惠金额=Discount Amount
已收货金额=Received Amount
总金额=Total Amount
已付金额=Paid Amount
未付金额=Payables
冲销金额=Offset Amount
本次付款=Payment
优惠金额不能大于订单总金额=Discount amount cannot be greater than the total order amount.
没有可付款的单据，不能保存哦=There are no orders with payables found and cannot be saved.
销售单号=SO No.
计划收款日期=Due Date
销售日期=Sales Date
已送货金额=Delivered
已收金额=Amount Received
未收金额=Receivables
本次收款=Payment received
没有可收款的单据，不能保存哦=There are no orders with receivables and cannot be saved.
请输入供应商分类名=Enter vendor Type
收货单号=Goods Receipt No.
查看送货单=View delivery order
收货日期=Good Receipt Date
收货金额=Received Amount
收货地址=Receiving Address
制单人=Created by
关联采购=Related Purchase
查看采购单=View PO
抱歉，没有欠此供应商款，不需要付款=You do not need to pay this vendor as no payables found. 
供应商被禁用=Vendor is suspended.
确定要禁用吗？=Confirm to suspend?
确定要启用吗？=Confirm to enable?
金额输入有误=Amount entered has error.
未收货=Pending
付款状态=Payment Status
收货状态=Goods Receipt Status
付款日期=Payment Date
付款金额=Payment Amount
付款账户=Payment Type
编辑调拨单=Edit transfer orders
新增调拨单=Create transfer orders
确定要删除此采购单吗？=Confirm to delete the PO?
编辑采购单=Edit PO
保存=Save
确定要删除此收货单吗？=Confirm to delete this receipt order?
编辑收货单=Edit Receipts
确定要删除此退货单吗？=Confirm to delete this return order?
编辑退货单=Edit RO
新建退货单=New Refund
确定要拒收此销售单吗？=Confirm to reject this SO?
确定要删除此销售单吗？=Confirm to delete this SO?
确定要转为销售单吗？=Confirm to convert as SO?
转换成功=Successfully converted
确定撤销转换，快捷开单就不能转换为销售合同啦？=Confirm to undo the conversion?
撤销转换=Smart Conversion
确定要拒收此送货单吗？=Confirm to reject this DO?
确定要删除此送货单吗？=Confirm to delete this DO?
编辑送货单=Edit DO
订单摘要=Order Summary
金额=Amount
余额=Balance
秒币=BIZGO Currency
自定义数额=Custom Amount
200元=$200
账单明细=Order Details
请先去购买秒账哦=Purchase BIZGO Prime license first
支付宝充值结果确认=Apple Pay top-up confirmation
查看支付结果=View payment results
恭喜您，充值成功=Top-up is successful.
抱歉，充值失败=Top-up failed.
详情可咨询客服=Contact customer service for details.
微信充值结果确认=Google Pay top-up confirmation
二维码生成失败=QR Code generation failed.
请输入充值金额=Enter top-up amount
请选择充值方式=Select the top-up method
充值时间：=Time:
到期时间：=Expire date:
此优惠券已验证通过，勾选即可使用=This coupon has been verified and can be used.
恭喜您，购买成功，重新登录即可使用哦=Purchase is successful and can be used once login to your account. 
只能选择同种使用条件的优惠券=Can only select coupons with similar conditions. 
已使用优惠券=Used coupon
用户包=Package
基础=Basis
智能=Intelligent
取消订单=Cancel order
订单号=Order No.
订单模块=Order Module
下单时间=Time ordered
开始时间=Start date
到期时间=Expired date
订单状态=Order Status 
订单详情=Order details
确定要取消此订单？=Confirm to cancel this order?
订单创建失败=Order creation failed
生成订单号失败=Failed to generate Order No.
个月=Months
电话号码格式不正确=Incorrect contact number format
编辑收货地址=Edit shipping address
新增收货地址=New shipping address
买=Purchase
立享=Enjoy
折=discount
秒账专用券=BIZGO Coupon
使用=use
p包=p package
敬请期待=Coming soon
月租金：=Monthly rent:
押金：=Deposit:
年保修，送修=Annual warranty, repair
送货：免费送货上门=Delivery: Free delivery
计算中=Calculating
恭喜您，可以免费试用=Congratulations, you can try it for free.
功能=Function
天了，重新登录即可体验哦=Log in to try BIZGO Prime again. 
测试账号只是方便您查看购买服务，请您点击右上角退出按钮，登陆您的账号，去购买属于自己的秒账吧=This Demo Account is for you to view our service. Log in to your own account to purchase BIZGO Prime. 
请选择要购买的项=Select item to purchase
请先去填写收货地址哦=Fill in shipping address.
优惠券=Coupon
已选择=selected
支付宝购买结果确认=Apple Pay purchase confirmation
抱歉，支付失败=Payment failed
微信购买结果确认=Google Pay purchase confirmation
秒帐服务协议=Service agreement
请选择客户类别=Select customer type
多个邮箱,逗号隔开=Use commas to separate multiple e-mail address. 
请选择供应商类别=Select vendor type
邮箱格式错误=Incorrect e-mail format
公司名称=Company Name
月总计=Monthly summary
年总计=Yearly summary
关联业务=Related Document
查看=View
查看通用单据（=View general orders (
查看费用支出=View expenses
查看其他收入=View other income
退款单=Return Order
凭证详（=Certificate details
）情=) Information 
请输入公司名或者电话=Enter company name or number
请选择类别=Select type
请选择明细=Select details
暂无明细=No details
月份=Month
资金支出表=Expense Statement
-01至=-01 to
月份=Month
资金支出=Income Expense
汇总付款=Payment Summary
总计=Total
暂无=No
付款金额输入有误=Incorrect payment amount entered.
请输入客户名或者电话=Enter customer name or contact no.
资金收入表=Income Statement
资金收入=Income
汇总收款=Total receivables
请输入供应商名称=Enter the vendor name
采购退货表=Purchase Refund Details
请输入客户名称=Enter customer name
(费用垫付：=(Payment on account:
本期送货：=Current Delivery
本期收款：=Current Payment 
本期未收款：=Current Receivables 
累计欠款：=Total Receivables
(冲销欠款=(Credit Offset  
(被冲销=(Offset
(税额&nbsp;&=(Tax Amount&nbsp;&
(优惠&nbsp;&=(Offers&nbsp;&
实际应退：=Actual Refund
退款金额：=Refund Amount
送货金额：=Delivery Amount
已收款：=Payment Received
未收款：=Receivables
超收款：=Over-received
款项=Payment
送货日期=Delivery Date
客户对账单=Customer Reconciliation Report
收货明细表=Goods Receipt Details
-01-01至=-01-01 to
客户销售明细=Sales Details
送货明细表=Delivery Note Details
发送时间=Send date
邮件内容=Email content
查看详情=View details
邮件主题=Email subject
收件邮箱=Inbox
收件人=Recipient
操作人=Operator
该单子已删除=This order has been deleted.
收支年报=Annual Income & Expense Report
销售欠款汇总=Receivables Summary
采购付款汇总=Payables Summary
供应商采购明细=Purchase Details 
销售流水=Sales Orders Report
采购流水=Purchase Orders Report
产品销售总览=Items based on Sales Report
数量输入有误=Incorrect Qty
请输入供应商名称或者电话=Enter vendor name or phone number
无收货明细哦=No receipt details
请输入供应商名或者电话=Enter vendor name or phone number 
采购付款汇总表=Payables Summary
2000-01-01 至=2000-01-01 to 
未付款=Payables
占比=Proportion
总未付=Amount due
计划收货日期=Due date
收到日期=Date received
销售欠款汇总表=Receivables Summary
客户销售明细表=Sales Details Report
供应商采购明细表=Purchase Details Report
销售业绩=Sales (performance) Reports
供应商对账单=Vendor Reconciliation Report
销售退货表=Sales Refund Report
点击查看更多报表=More Reports
收起=Collapse
欠款=Receivables
欠款=Receivables
总欠款=Total Payables
(费用自付：=(Self-paid
无送货明细哦=No delivery details found
请输入或选择员工名称=Enter or select staff name
产品名称=Item Name
毛利=Gross Profit
计划送货日期=Expected Delivery date
送出日期=Delivery date
本期收货：=Goods Receipt:
本期付款：=Paid:
本期未付款：=Payables:
累计未付款：=Total Payables:
收货金额：=Amount Receivedt
已付款：=Paid Amount
未付款：=Receivables:
获取验证码=Get Verification Code
重新发送=Send again
确认邮箱=Confirm e-mail
号码=Number
确认手机号码=Confirm contact number
获取验证码(=Verification Code(
中国=China
中国香港=Hongkong
中国澳门=Macau
中国台湾=Taiwan
新加坡=Singapore
印度=India
印度尼西亚=Indonesia
注册秒账=Sign Up
注册失败=Registration failed
注册成功=Registered successfully 
邀请码=Invitation code
请仔细阅读隐私条款并同意用户协议=Read the Privacy Policy and agree to the User Agreement
正在加载中=Loading
每页显示=Display 
条记录=records
对不起，查询不到相关数据=Cannot find the relevant data
当前为=Currently at
页,总页数为=page, the total number of pages is
没找到数据=Data not found
(从=(from
条数据中检索)=search from data)
搜索=Search
首页=First page
末页=Last page
请选择或输入类别=Select or enter the category type
单号只能为数字和字母的组合哦，单号最长32位=Order No. can only be combination of alphanumeric and cannot exceed 32 characters.
该类别没有明细无需填写=No need to fill in the details
必须是非0数字=Cannot be 0
规格不能重复=Dimensions cannot be repeated
颜色不能重复=Colour cannot be repeated
客户分类=Customer Type
折扣=Discount
同步之后，您此产品所有的规格都会同步到商户设置的统一规格型号哦=All item dimensions will be reflected as the standard dimensions specified. 
同步之后，您此产品的所有的颜色都会同步到商户设置的统一颜色哦=All colour dimensions will be reflected as the standard colour specified. 
批量操作开启后，您的所有属性值都会与第一组对应的属性值相同哦=Once batch action function is enabled, all attributes will be the same. 
请选择单位=Select unit
只能输入数字、字母=Can only enter alphanumeric
请输入颜色描述=Enter colour description
规格型号不能相同=Dimensions cannot be similar
标签个数不能超过13个哦=Cannot exceed 13 tags
标签只能输入中文、数字及英文=Only Chinese, English and numbers are allowed
苏州仓库=Suzhou Warehourse
南京仓库=Nanjing Warehouse
急需=Urgent
小明=Xiao Ming
查看调拨单=View transfer orders
调拨日期=Transfer date
调出仓库=Transfer-out Warehouse 
调入仓库=Transfer-in Warehouse 
新建调拨单=Create new transfer order
调拨单=Transfer Order
查看对应销售单=View corresponding SO
此采购单没有对应的销售单=There is no corresponding SO for this PO.
(收入)=(Income)
(支出)=(Expenses)
请输入类别=Enter Category
请输入明细=Enter details
请选择=Select
查看费用详情=View payment details
类别-明细=Category - Details
方式=Payment Type
费用收入（=Income(
新增费用收入=Add new Income and Expense
您选择的类别被删除了，请注意下哦=The category you selected has been deleted.
格式不正确=Incorrect format
产品=Item
请填写规格描述=Enter the dimension description
检查到您修改的规格型号，已经被订单使用，是否继续修改，订单的该规格型号会同步修改=The dimension you modified has been used in the orders. If you wish to proceed, all the related orders with this dimension will be changed. 
检查到您修改的颜色，已经被订单使用，是否继续修改，订单的该颜色描述会同步修改=The colour you modified has been used in the orders. If you wish to proceed, all the related orders with this colour will be changed. 
全部仓库=All warehouses
请输入产品名称或货号=Enter item name or item no.
实际数量=Actual Qty
数量差额=Qty Diff.
成本均价=Average Cost
成本均价(=Average cost(
变更为=Change to
库存减少=Inventory Outflow
库存增加=Inventory Inflow
查看库存详情=View inventory details
总价：=Total amount:
总数：=Total Qty:
名称=Name
库存警报=Low Inventory Alert
更新日期=Updated Date
盘存=Stocktake
库存=Inventory
库存期初/盘点=Initial inventory
入库=Inflow
出库=Outflow
详情=Details
查看关闭历史日志=View closed history log
历史库存=Historical Inventory
一次只能导入一个文件,请删除后重新导入=Can only upload one file each time. To import, delete and upload again
待审=Pending
已批=Approved
已拒=Rejected
不需审批=No approval needed
未提交=Not submitted
进行中=Processing
已完成=Completed
作废=Obsolete
查看付款单=View receipt
摘要=Details
审批状态=Approval status
现状=Current status
付款单（=Payment order(
请选择或输入单位=Select or enter units
查看产品详情=View item details
货号=Item No.
参考售价=Sales Price
必须选择两个或两个以上的产品进行合并=Select at least two items to merge.
编辑产品=Edit the item
请选择要添加标签的产品哦=Select the item to add tag
请填写标签=Fill in the tags
(客户)=(Customer)
(供应商)=(Vendor)
请输入客户或供应商分类名=Enter customer or vendor type
查看退货单=View Return Order
退货日期=Return Date
实际应退=Actual Refund
退款金额=Refund Amount 
退款状态=Refund Status
业务=Business
查看销售单=View SO
查看对应采购单=View corresponding PO
此销售单没有对应的采购单=This SO does not have corresponding PO 
当前状态下不可收款=Cannot receive money currently
当前状态下不可送货=Cannot deliver currently
抱歉，请选择可以打印的项哦=Select the page that can be printed
草稿、快捷单据等都是不可以打印的=Drafts and quick orders cannot be printed
草稿、快捷单据等都是不可以打印的,已经被过滤=Drafts and quick orders that cannot be printed have been filtered
送货单号=Delivery Order No.
送货金额=Delivered Amount
送货地址=Delivery Address
关联销售=Related Sales
系统通知：=Notification:
入参错误=Entry error
只能是数字=Can only be in numbers
盘盈=Inventory profit
盘亏=Inventory loss
,请确认？=, confirm?
查看产品规格和颜色库存=View inventory with dimensions and colour
编辑费用收入=Edit 
登录=Log In
打印=Print
导出=Export
操作类型=Action
长宽高=Carton Size
颜色描述不能重复=Colour description cannot be repeated
内容为空的字段已经被存为默认值=Fields that are blank have been saved as default
格式不正确，请重新输入=Incorrect format, enter again.
保存失败=Save failed.
至少选择一个行业=Select at least one industry
最多可选五个行业=Select at most five industries
操作成功，刷新后生效=Refresh to view the new changes
确认开启此功能，数据会根据您开启的功能做出相应的改动哦=Your data will change based on the functions that you enabled
送(收)货模块、=Deliver (Receipt) Module
退货模块=Goods Return
模块=module
风险提示：=Alert:
送(收)货模块=Deliver (Receipt) Module
设置库存数量在单据中的展示方式=Set inventory display method
选择展示副单位数量，单据界面可以看到1箱2包3个，这样格式的库存数量哦=Once you select to display quantity based on units, it will be reflected as 1 carton 2 bags 3 items format. 
选择折扣类型=Select discount type 
按需要选择产品折扣或者整单折扣，可以两个同时选择哦=Discount can either be entered as discount rate or discount amount, or both. 
(/规格、/=(/dimension,/
(/、颜色/=(,colour/
支付账户=Account
不能为空=Cannot be blank
新增账户=Add new account
编辑账户=Edit account
请选择仓管人员=Select warehouse staff
请选择地址=Select address
请选择一项=Select one 
仓库名称=Warehouse Name
默认=Default
地址=Address
新增仓库=Add new warehouse
修改失败=Edit failed.
该用户名已被使用=This username has been taken
添加失败=Failed to add
删除仓库的同时,涉及到的产品库存数量会一起被删除掉,确认删除吗？=By proceeding to delete this warehouse, inventory records will also be deleted. Confirm to delete?
编辑仓库=Edit warehouse
仅展示总数量=Display total qty
展示副单位的数量=Display Qty as sub-units.
 您好，关闭分仓管理属于高危操作，在操作前请仔细阅读下述风险提示内容：=Read the following carefully before proceeding to disable Warehouse Management:
关闭分仓管理后，默认仓库对应的库存数量会被继续使用= Inventory from the default warehouse will continue to be used.
关闭分仓管理后，其他仓库对应的产品库存数量整体被隐藏，不可以再次使用，请在关闭前调入默认仓库= Inventory from other warehouses cannot be used. If you wish to use, transfer to the default warehouse before disabling. 
关闭分仓管理后，仓库对应的老单子，可以继续查看、编辑和打印= Orders can still be viwed, edit and print. 
关闭分仓管理后，新增单子不可以再次选择仓库= You cannot select the warehouse when creating new orders. 
关闭分仓管理只是隐藏仓库列表，不执行删除操作=Once it is disabled, only Warehouse Reports will be hidden. The module will not be deleted. 
再次打开会全部显示=The above information will be displayed once it is enabled.
产品折扣=Discount %
整单折扣=Discounted Amount
&nbsp;&nbsp;&nbsp;&nbsp;您好，关闭s=&nbsp;&nbsp;&nbsp;&nbsp;Closing
属于高危操作，在操作前请仔细阅读下述风险提示内容：=this is a high-risk action, read the following before proceeding:
对应的产品属性：期初库存、库存预警、每箱数量、外箱尺寸、售价、进价等全部清空（隐藏），其对应产品这些属性值全部初始为0（若打开 s= Corresponding item attributes: initial inventory, low inventory alert, quantity per box, carton size, selling price, purchase price, etc. will be cleared (hidden), and items with these attributes will display as (All settings 
之前有设置，则还原原值）=2 will be cleared)
2对应的老单子，可以正常查看、编辑和打印= You can still view, edit and print 2 orders.  
2对应的库存数量会直接清空（隐藏），不承接在产品上，产品的库存数量会初始为0（若打开s=2 The corresponding stock quantity will be emptied (hidden) as 0 (if open s
2对应的均价会直接清空（隐藏），不承接在产品上，产品的均价会初始为0（若打开s=2 The corresponding average price will be emptied (hidden) as 0 (if open s
2对应的库存出库、入库日志在库存界面清空（隐藏），可以在产品库存明细里面点击查看=2 corresponding inventory outflow and inflow log will be cleared (hidden) in the inventory tab. Click on inventory details to view. 
关闭只是隐藏s=2 is only hidden s
不执行删除操作= operation will not be deleted. 
再次打开会全部显示，若想删除s=If it is enabled, all will be shown. If you want to delete s
请去产品界面，点击删除（禁用）按钮删除（禁用）= go to the Item Tab and click the delete (suspend) button to delete (suspend)
保存成功=Saved
阿尔及利亚=Algeria
阿富汗=Afghanistan
阿根廷=Argentina
阿拉斯加=Alaska
阿鲁巴岛=Aruba
阿曼=Oman
阿尔巴尼亚=Albania
阿森松=Ascension
埃及=Egypt
埃塞俄比亚=Ethiopia
爱尔兰=Ireland
安哥拉=Angola
安圭拉岛=Anguilla
奥地利=Austria
澳大利亚=Australia
澳门=Macao
巴巴多斯=Barbados
巴哈马=Bahamas
巴基斯坦=Pakistan
巴拉圭=Paraguay
巴林=Bahrain
巴拿马=Panama
巴西=Brazil
保加利亚=Bulgaria
贝宁=Benin
比利时=Belgium
冰岛=Iceland
波多黎各=Puerto Rico
波兰=Poland
玻利维亚=Bolivia
伯利兹=Belize
博茨瓦纳=Botswana
不丹=Bhutan
布基拉法索=Burkina Faso
布隆迪=Burundi
朝鲜=Korea
赤道几内亚=Equatorial Guinea
丹麦=Denmark
德国=Germany
东萨摩亚=East Samoa
多哥=Togo
俄罗斯=Russia
厄瓜多尔=Ecuador
法国=France
法罗群岛=Faroe Islands
法属圭亚那=French Guiana
梵蒂冈=Vatican
菲律宾=Philippines
斐济=Fiji
芬兰=Finland
佛得角=Cape Verde
福克兰群岛=Falkland Islands
冈比亚=Gambia
刚果=Congo
哥伦比亚=Colombia
哥斯达黎加=Costa Rica
格陵兰岛=Greenland
古巴=Cuba
关岛=Guam
圭亚那=Guyana
海地=Haiti
韩国=Korea
荷兰=Netherlands
洪都拉斯=Honduras
基里巴斯=Kiribati
吉布提=Djibouti
几内亚=Guinea
几内亚比绍=Guinea-Bissau
加拿大=Canada
加纳=Ghana
加蓬=Gabon
柬埔寨=Cambodia
津巴布韦=Zimbabwe
喀麦隆=Cameroon
卡塔尔=Qatar
科科斯岛=Cocos Island
科克群岛=Cork Islands
科摩罗=Comoros
科特迪瓦=Cote d'Ivoire
科威特=Kuwait
肯尼亚=Kenya
莱索托=Lesotho
老挝=Laos
黎巴嫩=Lebanon
利比里亚=Liberia
利比亚=Libya
列支敦士登=Liechtenstein
留尼旺岛=Reunion
卢森堡=Luxembourg
卢旺达=Rwanda
罗马尼亚=Romania
马达加斯加=Madagascar
马尔代夫=Maldives
马耳他=Malta
马拉维=Malawi
马来西亚=Malaysia
马里=Mali
马提尼克=Martinique
毛里求斯=Mauritius
毛里塔尼亚=Mauritania
美国=United States
蒙古=Mongolia
孟加拉国=Bangladesh
秘鲁=Peru
缅甸=Myanmar
摩洛哥=Morocco
莫桑比克=Mozambique
墨西哥=Mexico
纳米比亚=Namibia
南非=South Africa
南斯拉夫=Yugoslavia
瑙鲁=Nauru
尼泊尔=Nepal
尼加拉瓜=Nicaragua
尼日尔=Niger
尼日利亚=Nigeria
纽埃岛=Niue
挪威=Norway
诺福克岛=Norfolk Island
葡萄牙=Portugal
普林西比=Principe
日本=Japan
瑞典=Sweden
瑞士=Switzerland
萨尔瓦多=Salvador
塞拉利昂=Sierra Leone
塞内加尔=Senegal
塞浦路斯=Cyprus
塞舌尔=Seychelles
沙特阿拉伯=Saudi Arabia
圣诞岛=Christmas Island
圣多美=Sao Tome
圣赫勒拿=St. Helena
圣卢西亚=Saint Lucia
圣马力诺=San Marino
斯里兰卡=Sri Lanka
斯威士兰=Swaziland
苏丹=Sudan
苏里南=Suriname
所罗门群岛=Solomon Islands
索马里=Somalia
台湾=Taiwan
泰国=Thailand
坦桑尼亚=Tanzania
汤加=Tonga
突尼斯=Tunisia
图瓦卢=Tuvalu
土耳其=Turkey
瓦努阿图=Vanuatu
危地马拉=Guatemala
威克岛=Wake Island
维尔京群岛=The Virgin Islands
委内瑞拉=Venezuela
文莱=Brunei
乌干达=Uganda
乌拉圭=Uruguay
西班牙=Spain
西萨摩亚=Western Samoa
希腊=Greece
夏威夷=Hawaii
香港=Hong Kong
新西兰=new Zealand
匈牙利=Hungary
叙利亚=Syria
牙买加=Jamaica
伊拉克=Iraq
伊朗=Iran
以色列=Israel
意大利=Italy
英国=United Kingdom
约旦=Jordan
越南=Vietnam
赞比亚=Zambia
扎伊尔=Zaire
乍得=Chad
直布罗陀=Gibraltar
智利=Chile
中非=Central Africa
中途岛=Midway Island
男=Male
女=Female
是=Yes
否=No
密码长度应为6-20位,不能有空格=Password should be 6-20 characters long and cannot have spaces
只能是数字、字母、下划线=Can only be alphanumeric and underscores
下划线不能开头或结尾=Underscore cannot be at the beginning or end
两次密码不一致=Password do not match
请与电子邮箱择一填写=Fill in e-mail address
邮箱格式不正确=Incorrect e-mail format 
用户名=User Name
姓名=Name
手机号码=Mobile
角色=Role
创建人=Created by
创建日期=Date Created
分配角色=Assign Role
添加员工=New User
角色名称=Role
角色描述=Description
编辑员工=Edit staff
请选择角色=Assign role
预收款项=Advancement 
销售单（未送货）=SO (not delivered)
应收款项=Receivables
逾期应收=Overdue receivables
采购订单=PO
确认框=Confirmation box
弹出框-错误=Confirmation box - Error
弹出框-警告=Confirmation box - Warning
弹出框-消息=Confirmation box - Message
现在时间：=Time:
世界=World
模拟成功测试=Simulation test is successful 
模拟成功测试--出错=Simulation test - Error
没有弹出框测试=No pop-up test
没有弹出框测试--出错=No pop-up test-Error
500错误=500 Error
非=Not
n返回值=n Return value
n返回值-出错=n Return value--Error
404测试--不会调用=404 Test - Cannot calll
404测试=404 Test
陈小谦=Chen Xiaoqian
发版维护公告=Maintenance Announcement
微软雅黑=Microsoft Yahei
服务维护全面升级中=Upgrading
嗨，各位小主好=Hello 
夏日到了，秒账也要扮新=BIZGO will upgrade 
装=appearance
为此，系统于2018年6月10日晚9点到凌晨2点进行版本迭代更新升级，届时将暂停服务，若给小主带来不便，望小主多多包涵哦=The system will be updated and upgraded from 9:00 pm to 2 am on June 10, 2018. All services will be suspended at that time. Sorry for the inconvenience caused.
马上为您奉上新版功能，请小主预览：=New features preview: 
系统= System
全面改版，清新明了=Revamped with a clearer interface 
系统版本全面优化，速度更快、服务更优=Fully optimized, faster speed and better functions. 
电脑端选择扫码，开单更加快捷=Select scan barcode on PC to quickly place order.
每个账号自定义打印模板，分店打印更加智能= Customize the print templates to allow printing based on your requirements.
税率、总数量自定义输入，满足全方位需求= You can enter tax rate, total qty depending on your requirements.  
不允许修改=No modification is allowed
时请注意，这个仅限于前端静态资源请求的前缀，后台资源请求请使用=Note: This is limited to the prefix of the front-end static resource request. Please use back-end resource request.
更多=More
&nbsp;修改密码=&nbsp;Change password
&nbsp;帮助=&nbsp;Help
&nbsp;快捷方式=&nbsp;Shortcut
&nbsp；退出Logout
&nbsp;&nbsp;&nbsp;&nbsp;&nbsp;&nbsp;=&nbsp;t&nbsp;&nbsp;&nbsp;&nbsp;&nbsp;&nbsp;
购买=Buy
&nbsp;我的购买=&nbsp;Cart
&nbsp;我的秒账=&nbsp;My Account
消息=Message
消息通知=Notifications
收款信息=Receive Payment
付款信息=Payment 
送货信息=Goods Delivery
收货信息=Goods Receipt
刷新=Refresh
商务贷款=Loan
充值购买=Top-up purchase
消息提醒=Messages
&nbsp;&nbsp;&nbsp;我的秒账=&nbsp;&nbsp;&nbsp;My Account
&nbsp;&nbsp;&nbsp;基础导航=&nbsp;&nbsp;&nbsp;Basic navigation
&nbsp;&nbsp;&nbsp;修改密码=&nbsp;&nbsp;&nbsp;Change password
&nbsp;&nbsp;&nbsp;刷新=&nbsp;&nbsp;&nbsp;Refresh
&nbsp;&nbsp;&nbsp;退出=&nbsp;&nbsp;&nbsp;Logout
订单号=Order No.
应付总额=Total payables
立即支付=Immediate Payment
上一步=Previous
欢迎来到基础导航=Welcome to basic navigation
下一步=Next
完成=Finish
&nbsp;邮件历史=&nbsp;Email history
&nbsp;充值购买=&nbsp;Top-up purchase
&nbsp;订单历史=&nbsp;Order history
秒账上传=BIZGO Prime upload
上传结果=Result
D:\git\SimpleAC\SimpleAC\page\common\虹光控件 Avision Controls
秒账商户版=BIZGO Prime
秒账商业版=BIZGO Prime 
欢迎您加入秒账=Welcome to BIZGO!
业务智能化 统计实时化=Intelligent Business & Real-time Statistics.
高效协同信息流 实时掌握核心数据 一体化服务管理模式=
Efficient and synergetic information flow; Real-time core data involved; Integrated service management mode.
提供云平台解决方案 助力微小企业进入高速跑道=
Providing micro businesses with cloud platform solutions stimulating high-speed development.
注册=Sign Up
密码=Password
登 录=Log in
记住密码=Remember my password
登录体验账号=Demo Account
忘记密码？=Forgot Password
账号=Account
中全网-云会计=Zhongquan.com - Cloud Accounting
忘记密码&=Forget my password&
还没有账号？=Don’t have an account yet?
新用户注册=New user registration
周数据=Weekly data
月数据=Monthly data
客户未收款=Receivables
更多&=more&
供应商未付款=Payables 
立即下载=Download now
忘记密码页面=Forget Password Tab
登&nbsp;录=Log in&nbsp;
注&nbsp;册=Sign&nbsp;Up
忘记密码=Forget Password
若忘记用户名或已更换手机号码或邮箱，请联系客服=If you forget your user name or changed your mobile number or email, please contact the customer service.
重置密码=Reset password
图形验证码=Captcha
图形验证码不能为空=Captcha cannot be blank
图形验证码不正确=Invalid captcha
我们将发送验证码到=We will send the verification code to
用户名不存在=User name does not exist
验证码=Verification Code
验证码不能为空=Verification Code cannot be blank
验证码不正确=Incorrect Verification Code
输入密码=Enter password
密码长度为6-32个字符=The password length is between 6-32 characters
再次输入密码=Confirm password
提&nbsp;&nbsp;&nbsp;&nbsp;&nbsp;交=Submit&nbsp;&nbsp;&nbsp;&nbsp;&nbsp;
修改成功=Successfully modified
返回登录页=Back to login page
返回登录=Return to login
新手导航=New user guide
立 即 注 册 秒 账=Register BIZGO Prime now
注册页面=Registration
欢迎注册秒账=Welcome to BIZGO Prime registration
填写手机号或邮箱=Enter contact number or e-mail
设置账户及密码=User name and password
注册信息=Registration Information
手机号或者邮箱=Contact No. or e-mail
手机号或者邮箱不能为空=Field cannot be blank
请输入有效的手机号或者邮箱=Enter valid mobile number or e-mail
用户名已存在=User name already exists
只能是数字,字母,下划线=Can only be alphanumeric or underscores.
密码长度为6-32个字符 , 不能有空格=The password must be 6-32 characters long and cannot have spaces
默认密码为 123456，可以现在填写，也可以登录后修改=The default password is 123456 and you can change it after logging in..
邀请码（选填）=Invitation Code (Optional)
只能为数字、字母=Can only be alphanumeric.
邀请码错误，请重新输入或不填=Incorrect verification code. Enter again or leave blank. 
注&nbsp;&nbsp;&nbsp;&nbsp;&nbsp;册=Register
我已阅读并同意=I have read and agree to
隐私条款=Privacy Policy
和=and
用户协议=User agreement
重新注册=Register again
马上下载=Download now
，帮您轻松解决,=to solve your issues,
录账烦恼=Accounting problems 
点击下载=Click to download
注册展示信息=Registeration Information
注册日期=Registration Date
账目启用月=Opening month
简称=Type
详细地址=Street Address
邮编=Postal Code
新增客户分类=New Customer Type
新增分类=New category
//加载种类= Category Loading
新增供应商分类=New Vendor Type
请输入类别名称=Enter type name
请输入分类名称=Enter category name
    //保存= Save
        //规格型号= Specifications and models
分类名称不能为空=Category name cannot be blank.
类别名称不能为=Type name cannot be
类别名称不能为未分类=Type name cannot be uncategorized
分类名称不符合要求=Category name is invalid.
分类名称不能重复=Category name cannot be repeated.
            //如果删除的正好是被选中的,就让选中后面一个=
If the delete happens to be the one selected, let the latter one be selected.
确认删除此类别？=Confirm to delete this type?
                        //如果删除的正好是被选中的,就让选中后面一个=
If the delete happens to be the one selected, let the latter one be selected.
添加地址=Add Address
公司地址=Company Address
邮编格式错误=Incorrect postal code format 
编辑地址=Add Address
新增收货人=New consignee
职务=Occupation
手机=Mobile
为了更好的体验秒账，请留下您的联系方式吧=Include your contact information to enjoy a better BIZGO Prime experience. 
电话号码=Contact No.
去体验=Demo
手机号码格式错误=Incorrect contact number format
测试账号登录=Demo Account login
订单作废不需要转换了=Order is void and no need to be converted
赶时间，暂时不需要转换了=No need to convert for the time being
智能转换时间太长=Conversion duration is too long 
智能转换错误率太高=SO converted has too much errors
手误，不小心点错了提交=Submitted the wrong SO
其他=Others
提交=Submit
请选择撤销原因=Reason must be selected
可以直接修改分类的总名称及各分类名称=You can directly edit category name
下载模板=Download Template
导入种类=Import type
进销存流程已关闭=Sales invoice generation is closed. 
您好， 属于高危操作，在操作前请仔细阅读下述风险提示内容：=Read the following before proceeding: 
规格对应的产品属性：期初库存、库存预警、每箱数量、外箱尺寸、售价、进价等全部清空（隐藏），不承接在产品上=1) Item attributes corresponding to the dimensions: initial inventory, inventory warning, quantity per box, outer box size, selling price, purchase price, etc. will be cleared (hidden) and item will not be accepted. 
规格对应的老单子，可以正常查看和打印，但是重新编辑会直接清空规格信息，并且不可以再次选择此规格= The previous orders corresponding to the dimensions can be viewed and be printed normally. Editing will clear the dimension information and the dimensions cannot be selected again.  
规格对应的库存数量会直接清空（隐藏），不承接在产品上= The inventory corresponding to the dimension will be directly cleared (hidden) and it will not be accepted on the item.  
规格对应的均价会直接清空（隐藏），不承接在产品上= The average price corresponding to the dimensions will be directly cleared (hidden) and it will not be accepted on the item. 
规格对应的库存出库、入库日志在库存界面清空（隐藏），可以在产品库存明细里面点击查看= The dimensions corresponding to the inventory and the inbound log will be cleared (hidden) in the inventory tab. To view, click on the item inventory details.
禁用后不可以新增同名称的规格，可以启用原规格= After disabling dimensions, you cannot add dimensions with the same name. To use, enable it. 
您好，涉及到=All
 规格的组合已经全部删除，=dimensions have been deleted
 规格将被禁用=and suspended
禁用规格属于高危操作，在操作前请仔细阅读下述风险提示内容：=Please read the following before proceeding to disable the dimensions: 
规格对应的老单子，可以正常查看和打印，但是重新编辑会直接清空规格信息，并且不可以再次选择规格=2) The previous orders relating to the dimensions can be viewed and printed normally. Editing it will clear all the dimensions information and cannot be selected again. 
送货、收获流程已关闭=Delivery (Receipt) module is disabled
您好，禁用仓库属于危险操作，在操作前请仔细阅读下述风险提示内容：=Please read the following before proceeding to disabling the warehouse: 
被禁用的仓库，在单据界面不可以再次被选择到=1) The warehouse suspended cannot be selected again when creating orders on PO/SO Tab.  
被禁用的仓库，涉及到的旧单子可以被正常查看、打印，但是编辑会清空仓库信息，可以重新选择= The previous orders related to the suspended warehouse can only be viewed and printed. Editing it will clear all the warehouse information and cannot be selected again. 
被禁用的仓库涉及到的产品库存数量，不能被再次使用，可以被调拨= Inventory in the suspended warehouse cannot be used unless it is transferred to other warehouses. 
在库存界面搜索全部仓库的数量，不显示被禁用的仓库的产品数量，库存总数量、总价不统计被禁用的仓库库存数量和总价= When searching for inventory quantity in all the warehouses in the Inventory Tab, you will not be able to view the inventory and total inventory quantity in the suspended warehouse. It will also be excluded when calculating the total price. 
被禁用的仓库涉及到的产品没有被禁用= Items involved in the suspended warehouse will not be affected. 
选择颜色=Select colour
输入颜色描述查找=Enter a colour description to search
新增颜色=Add colour
新增颜色=Add colour
新增类别=New category
新增明细=New details
类别=Type
类别不能为空=Type cannot be blank
请先选择类别=Select a type first
明细不能为空=Details cannot be blank
确认删除此明细？=Confirm to delete this detail?
详情设置=Detail Settings
备用电话号码格式错误=Incorrect Alt Tel number.
自定义公式=Custom Formula
自定义数字=Custom Number
库存数量公式为空，已存为默认公式=Inventory formula is blank and default formula will be applied.
库存数量需要包含总数量=Total Qty needs to be included in the warehouse qty.
金额公式为空，已存为默认公式=Amount formula is blank and default formula is applied.
金额需要包含总数量=Total Qty needs to be included in the amount. 
金额需要包含单价=Unit price needs to be included in the amount. 
外箱尺寸、=Carton size
重量、=Wt.
装箱=Packing
商户设置没有打开=Not enabled in settings.
属性，是否同时在商户设置打开=Do you want to enable the attribute at the same time?
数据权限=Data permission
客户/供应商独立资源管理=Customer/Vendor Resource Management
客户资源=Customer’s resource
供应商资源=Vendor’s resource
销售信息独立资源管理=Sales Info Resource Management
销售退货单=Sales Return Note
采购信息独立资源管理=Purchasing Info Resource Management
采购退货单=Purchase Return Note
分配负责人=Assign staff
快速打印=Quick Print
针式蓝牙打印=Bluetooth Printing
打印显示属性=Print Attibutes
页眉设置=Page Header
分页显示页眉=Repeat on every page
请输入英文=Enter in EN
供中英文模板打印=For EN-CN print template
页脚设置=Page Footer
分页显示页脚=Repeat on every page
二维码显示在表头=Barcode 
4二等分=A4 half
4三等分=A4 third
4不分页=A4 non-paged
4横向=A4 Landscape
中英文打印=Print in English Chinese
打印金额=Amount
打印收款记录=Payment Received History
打印收款详情= Payment Received Details
打印送货数量=Delivery Qty
仅打印送货产品=Delivered Items 
打印非产品费用=Misc. Fees
客户货号、产品名称单独打印=Item No. and Item
打印条形码=Barcode
打印累计欠款=Accumulative Arrears
打印附件=Attachment
打印条款=Terms & Conditions
打印时间=Time
打印付款记录=Payment Records
打印付款详情=Payment Details
打印收货数量=Goods Receipt Qty
仅打印收货产品=Received Items 
打印图片=Image
打印重量=Wt.
打印货号=Item No.
打印副单位=Sub-unit
打印规格=dimension
合并打印规格=Dimensions
打印颜色=Colour
合并打印颜色=Combined Colours
打印仓库=Inventory
超级业务员=Superuser
纸张尺寸=Paper Size
保存的是=Save as
勾选后，在单据列表或者详情界面点击打印的时候，将不再进行打印属性选择，直接进入打印预览界面=Once selected, you will enter the print preview directly when you click Print. 
勾选后，单据详情比较长的情况下，打印分页，每页都显示页眉内容=Once selected, if the details of the document are long, the document will be printed in pages with the header displayed on each page.
勾选后，单据详情比较长的情况下，打印分页，每页都显示页脚内容=Once selected, if details of the document are long, document is printed in pages and the content of the footer is displayed on each page.
自定义列宽已超出=Exceeded the custom column width.
4纸总宽度，请重新调整=Adjust total width to fit A4.
仓库=Warehouse
请输入仓库名称=Enter warehouse name.
导出数据过大，需要分批导出哦，选择导出数据段：=As the export data is too large, you need to export in batches. Select the segment to export:
批量导入=Import
新增非产品费用=Add non-item cost
非产品费用=Misc. Fees
您没有选择非产品费用类别哦=You have not selected a non-item cost category. 
添加非产品费用=Add non-item fees
编辑的非产品费用不能为空=Field cannot be blank
非产品费用不能重复=Non-item cost cannot be repeated
确认删除此非产品费用？=Confirm to delete this non-item cost?
不可删除=Cannot be deleted
添加图片=Click to insert an image.
选择打印信息=Select print information
选择打印模板信息=Select print template information
热敏蓝牙打印=Bluetooth Print
流程是否需要审批=Is approval required for this process?
销售流程审批：在进行销售活动过程中的审批权限=Sales Process Audit: Approval authority during sales activities
报价单审批=Quotation approval
销售单审批=SO audit
收款单审批=Payment audit
销售退货审批=Sales return audit
采购流程审批：在进行采购活动过程中的审批权限=Procurement Process Audit: Approval authority during the procurement activity
采购单审批=PO audit
付款单审批=Payment order audit
采购退货审批=Purchase return audit
费用、收入流程审批：在进行收入、支出过程中的审批权限=Cost and income process audit: approval authority in the process of income and expenses
报销单审批=Reimbursement form approval
费用支出单审批=Expense bill audit
其他收入单审批=Other income order audit
矩阵开单=Quick Entry
可以方向键快速输入数量，可以=You can use direction key to quickly enter Qty, 
键保存输入数据=and click Enter to save data.
批量设置所有（选择规格型号或者颜色，可批量设置该颜色或规格的数量）=You can set the Qty in batches by selecting either dimensions or colour.
批量操作=Batch Actions
请去添加颜色或规格=Add colour or dimensions
种类名称=Category name
设置单位统一模板=Standard unit-Template
回车键，快速增加单位=Use Enter key to quickly add units
默认启用多单位=Enable multi-unit as default
新增多单位=New multi-unit
多单位设置=Multi-unit Settings
统计库存，以最小单位为准=Inventory based on sub-unit.
最小单位=Minimum Unit
增加副单位=New sub-unit
设置单位=Unit
单位名称=Unit Name
请输入产品单位=Enter unit.
请输入单位名称，点击=Enter item name,  then click
键完成新增=Enter to add.
单位不能为空=Unit cannot be blank.
该单位已存在，请重新输入=Unit already exists. Enter other units.
新增成功=Completed
请输入最小单位=Enter sub-unit.
至少有一个副单位=At least one sub-unit.
比例为0=Ratio is 0.
比例不能为空=Ratio cannot be blank.
副单位不能为空=Sub-unit cannot be blank.
该单位组已存在，请重新设定=This unit group exists. Set another one.
比例不能为零或空=Ratio cannot be blank or zero.
副单位至少保留一个=At least one sub-unit.
所选单位不能和其他副单位或最小单位重复，请重新选择=This unit is repeated. Select other sub-unit. 
单位至少保留一个=At least one unit shall be kept.
换算比例不能为空=Conversion rate cannot be blank.
最小单位和副单位不能为空=Basic unit and sub-unit cannot be blank.
编辑成功=Saved.
请填写驳回理由=Enter your rejection reason.
请填写驳回理由：=Enter your rejection reason:
驳回理由不可以为空哦=Rejection reason cannot be blank.
驳回成功，请耐心等待一下，小秒正在紧急识别中=Rejection is submitted. Processing...
请输入单号=Enter order no.
检测到该销售单对应的采购单还未收货，是否一起收货=Note that the PO corresponding to this SO has not been received yet. Do you want to do receiving? 
(/送/=(/send/
收=receive
(/收/=(/receive/
送=send
邮件发送=Send Email
主题=Subject
附件=Attachment
正文=Content
发送=Send
邮箱不能为空=Email field cannot be blank
此邮件是=This email is
商户=Enterprise
通过秒账平台给您发送的，回复邮件请复制=This is sent via BIZGO Prime. Copy
商户的邮箱回复哦=contact’s email address to reply.
祝您工作愉快，天天有个好心情=Have a nice day.
客户名称=Customer Name
快速收货=Quick receiving
送货地址=Shipping Address
未送数量=Qty to deliver
(/供应商/=(/vendor/
(/采购/=(/purchase/
(/客户/=(/customer/
(/销售/=(/sales/
欢迎使用秒账，请设置必要的信息完成商户的创建哦=Welcome to BIZGO Prime. Fill in the required company information. 
商户名称=Company Name
填写完整正确的商户名称，打印的单据、报表会更加正规哦=Name entered will appear on orders and reports. 
行业属性=Industry
选择正确的行业，可以得到秒账推送的更多的行业信息哦=Choosing the right industry will allow you to get related information. 
五金机械=Hardware
塑料胶带=Plastic adhesive tape
儿童玩具=Toys
围巾服饰=Clothes
鞋帽箱包=Bag
眼镜钟表=Watch & Glasses
文具用品=Stationery
包装纸业=Packaging & Paper
雨具=Umbrella
美容美妆=Cosmetic
床上用品=Beddings
电子产品=Electronics
家用电器=Home Appliances
日用百货=General Merchandise
布匹纺织=Textile
请选择您的行业=Select your industry.
公司名称不能为空=Company name cannot be blank.
请选择行业属性，且不超过五个=Can select at most 5 industry attributes 
最少选择一个行业=Select at least one industry.
新建规格型号=New dimension
选择规格型号=Select dimension 
输入规格描述查找=Enter the dimension description to find.
新增规格型号=New dimension
加急=Quick 
一般=Normal
特别加急(敬请期待)=Urgent (coming soon)
我已阅读并同意=I have read and agreed
智能转换协议=Smart Conversion Agreement
提交成功=Submitted successfully
系统消息：=System message:
系统=System
无系统消息=No system message
糟糕=Sorry,
，您购买的秒账服务期限已过=your BIZGO service is expired.
权限说明：=Permission Details:
进入并查看您所有的业务数据、单据和设置界面=View all your business data, invoices and settings
打印并导出您所有的单据和报表=Print out all transactions and reports.
不可新增单据和业务数据=Cannot add new transaction and business data.
不可对已有的业务数据、单据和设置界面进行编辑=Cannot edit existing business data and settings.
如有疑问，请拨打 400-0900-890，联系秒账客服哦=For further enqury, please reach our support team at
 公告=Announcement
您现在还可以这么做：=You can also:
打印并导出您所有的单据、凭证和报表=Print out and export your invoices, certificate and reports.
如有疑问，请拨打 400-7788-966，联系秒账客服哦=For further enqury, please reach our support team at
修改密码=Change password
原密码=Old password
新密码=New password
确认新密码=Confirm password
测试账号不允许修改密码哦=The test account password is not allow to be changed.
密码修改成功，请使用新密码重新登录=The password was successfully modified. Please log in again with the new password.
支出账户=Expenditure account
不能大于未核销金额=Cannot be greater than the unapplied amount
请填写细码数量=Please fill in the number of Metres Qty
(可使用键盘=(available keyboard
回车键=Enter Key
快速添加细码)=Quickly add Metres)
秒账收款=BIZGO receipt
金额(元)：=Amount (Dollar):
手机号：=Phone number:
备注：=Remarks:
注：1、请勿在微信/=Note: 1. Please do not use WeChat/
中打开，2、手机浏览器上请点击弹出页面里的=Open, 2, click on the pop-up page on the mobile browser
扫一扫付款=Scan payment
以切换至二维码=To switch to QR code
生成收款二维码=Generate QR Code
请在=Please
检查本次收款结果=Check the payment collection
确认收款后再=After confirming payment received,
开始下次收款=Next payment
秒账订单号：=BIZGO Order No.:
秒账状态更新：=BIZGO Prime Status update:
支付宝流水号：=Apple Pay serial number:
金额：=Amount:
支付结果：=Payment result:
查询收款历史=Check the payment history
无法获取订单号，请稍后重试=Unable to get order number, try again later
请填写有效手机号=Please fill in the valid mobile number
请填写有效金额=Please fill in the valid amount
创建订单失败，请稍后重试=Failed to create order,  try again later
成功=succeed
检查订单状态失败，请稍后重试=Check order status failed,  try again later
秒账收款历史=BIZGO payment collection history
用户名：=Username:
密码：=Password:
时间段：=Period:
从=From
中打开，2、请输入用户名、密码，以及至少一个查询条件后再点击=. 2. Enter either username or password to search and click
查询=Search
或者=or
导出明细为=Export Details
退出此页面请点击=Logout
无法查询历史记录，请稍后重试=Unable to search history. Try again later
请至少填写一个条件=Enter at least one condition
请填写用户名密码=Enter username and password
起始时间：=Start Time:
截止时间：=Deadline:
没有符合条件的记录=No matching record(s)
查询条件=Search condition
小计=Subtotal
调拨单号=Transfer Ref No.
订单信息=Sales Detail
货品装箱=Goods Packing
扫码=Scan the code
请扫描产品条形码=Scan the barcode
备注：（打印时显示）=Remarks
基本信息=Basic Info.
默认仓库=Default warehouse
批量删除=Mass delete
税率=Tax Rate
税额=Tax
订单金额：=Sales Amount
新增付款账户=Add new account
已收货：=Received
超付款：=Over payment
保存并打印=Save and Print
销售退货=Sales Refund
采购退货=Purchase Refund
退货单号=Return No.
退款金额=Refund
冲销欠款=Write-off
退款方式=Refund type
退货地址=Return Address
退货明细=Return Detail
退货金额：=Return amt
快捷开单=Quick Mode
快速批量采购=Batch PO
暂不送货=Pending Goods Delivery
部分送货金额=Partial delivery amt
图片快捷开单=Image
毛利：=Gross Profit：
已送货：=Delivered
智能转换=Smart Conversion
保存销售单=Save as Draft
草稿并打印=Print as Draft
存为草稿=Save as Draft
导入客户=Import
导出客户=Export
状态=Status
编&nbsp;&nbsp;&nbsp;辑=Edit
应付款项=Payables
销售记录=Sales History
资金往来=Receipt
客户信息=Customer Info.
创建销售单=New Sales
订单金额=Sales Amount
创建采购单=New Purchase
退款：=Refund Amt:
供应商名=Vendor Name
文件快捷开单=Quick Mode - File
新增收款账户=New receiving account
销售单并打印=Save and print
存为销售单=Save as SO
打印草稿=Print as Draft
付款列表=Payment List
未付总额：=Total Receivables:
收款列表=Receipt List
未收总额：=Total Receivables
批量操作&nbsp;=Batch Actions&nbsp;
采购、收货单号=PO, Goods Receipt Order
请输入送货地址=Enter shipping address
供应商分类=Vendor Type
导入供应商=Import
导出供应商=Export
采购记录=Purchase History
供应商信息=Vendor Info.
复制新增=Copy
继续采购=Continue Purchase
发邮件=Email
退货信息=Return Info
生成采购退货=Generate sales return order
生成采购单=Generate PO
手动转换=Manual conversion
转为销售单=Convert to SO
通过并打印=Approve and print
账户：=Account:
余额：=Balance
充值=Top-up
明细=Detail
我的优惠券=My Voucher
秒币仅能用于秒账的增值服务，不能兑换现金，不能进行转账交易，不能兑换秒账的主营产品以及秒账系统以外的其他产品和服务=
Bizcoin can only be used for value-added services of Bizgo and it cannot exchange cash、 conduct transfer transactions、exchange main products and other products and services beyongd Bizgo system.
充值数额=Top-up Amt
50 秒币
100 秒币
200 秒币
300 秒币
500 秒币
充值方式=Payment Mode
应付金额=Payable
00元=00 Dollars
立即充值=Top up
订单号：=Order No.
合计总额：=Total Amt
使用线下优惠券=Use coupon
请输入优惠券号码=Enter coupon number
验证券码=Validate coupon number
可用优惠券=Applicable coupons
请选择支付方式=Select payment mode
请选择支付账户
立即登录=Log in
购买信息=Purchase Info
适用于外贸型、内销型商户模式，让销售、采购、业务数据的管理实时化、智能化
电脑端、手机端、=Applicable for both international and domestic business models. Real-time and intelligent management of sales and purchases. 
端随时随地，一键掌控企业核心数据=Able to use it on PC, Mobile and tablets
购买时长=Subscription 
1年=1 Year
2年=2 Years
3年=3 Years
4年=4 Years
5年=5 Years
合计金额：=Total Amt
包=Premium Package
用户享受以下特权=Privileges 
期初导入数据、大量导出数据、清空数据=Early import, mass export and clean-up business data
1次半天的上门培训(差旅费另付)=Complimentary half-day training (Travel Expenses not included)
赠送100张智能转换订单=Free 100 smart conversion SOs
赠送200次催款、催货短信提醒(敬请期待)=Free 200 text reminders (coming soon)
所有的增值服务打8折(快捷订单智能转换、短信提醒等)=20% discount for Value-Added Services (Smart Conversion orders, text notification reminders etc)
优惠券号码=Coupon No.
增值服务包=Value-added package
秒账服务协议=BIZGO Prime Service Agreement
开单太慢？秒账改善，手机拍照，一键上传，纸质单据智能转换为订单合同，管理库存、管理产品，从此无忧=Need to quickly create order? Our OCR Smart Conversion will quickly convert and digitalize your print SOs 
超过赠送免费转换次数，每次转换按照服务类型收取费用，从秒账钱包直接扣除=Once complimentary SOs are used up, subsequent ones will be deducted directly from your account.  
催款催货短信提醒=Text Notification Reminders
周末清账、月末清账、季度清账、年底清账
秒账帮您，按您业务需要，定期给客户或者供应商发送催款、催货短信
超过赠送的短信数量后，每条短信收费0
2元，从秒账钱包直接扣除=
Weekends clearing, monthly clearing, quarterly clearing, yearly clearing.
Bizgo enables based on business needs：sending reminders of urgent payment and collection of to customers or suppliers on at regular intervals.
each SMS charge 0.2 yuan after exceeding the free number, directly deducted from the Bizgo wallet.
收货人信息=Consignee Info
注：所有产品图片以实物为准，该图片仅供参考=Note: All item images are subject to the actual item, the image is for reference only.
结算=Check payment
总金额=Total Amt
已选商品=Items selected 
件=item
请输入合作商使用券=Enter partner coupon
收货人=Consignee
请输入名字=Enter name.
联系电话=Contact No.
请输入手机或固定电话=Enter mobile & tel
请输入详细地址=Enter street address
微软雅黑= Microsoft Yahei Font
宋体=Song Typeface
我的收银台=My cashier
秒账充值=Top-up
收款方：益萃网络科技（中国）有限公司=Payee:BIZGO HOLDINGS PTE. LTD.
 元=Dollar
&nbsp;&nbsp;搜&nbsp;&nbsp;&nbsp;索=search
导&nbsp;&nbsp;&nbsp;出=Export
打&nbsp;&nbsp;&nbsp;印=Print
刷&nbsp;&nbsp;&nbsp;新=Refresh
搜&nbsp;&nbsp;&nbsp;索=Search
费用模块支出=Expenses
业务模块支出=Expenses from business operations
单位：元=Currency $
支出明细=Expense Detaisl
今日支出=Today’s Expenses
昨日支出=Yesterday’s Expenses
本年支出=This year’s Expenses
总支出=Total Expenses
公司名称/类别-明细=Category
费用模块收入=Cost module income
业务模块收入=Sales module income
收入明细=Income Details
今日收入=Today’sIncome
昨日收入=Yesterday’s Income
本年收入=This year’s Income
总收入=Total Income
请输入采购退货单号=Enter Sales Refund No.
请输入规格=Enter dimensions
请输入颜色=Enter colour
单位=Unit
退货日期&nbsp;&nbsp;&nbsp;=Return Date&nbsp;&nbsp;&nbsp; 
退货金额=Return Amount
公司：中全网云会计公司 =Company: China Cloud Accounting Company
明细账= Subsidiary Ledger
2015年3月23日 = 23rd,Mar,2015
类目一=Category 1
分类一=Type 1
分类二=Type 2
一级科目= Subject level-1
应收账款=Accounts Receivable
应付账款=Accounts Payable
其他应付账款=Other Accounts Payable
其他应收账款=Other Accounts Receivable
主营业务收入=Main income
主营业务成本=Main cost
其他业务收入=Other operating income
营业外收入=Non-operating income
营业外支出=Operating expenses
应付职工薪酬=Payroll payable
在建工程=Under construction
短期借款=Short term debt
长期借款=Long term debt
投资收益=Investment Income
库存现金=Inventory Balance
银行存款=Banking Balance
预付账款=Advancement
二级科目 Subject level-2
凭证号=Ref No.
借方=Debtor
贷方=Lender
票据=Receipt
票号=Invoice No.
初期余额=Initial Balance
记12= Records of 12
电脑=Computer
发票=Invoice
记14= Records of 14
主机=Desktop
记15= Records of 15
收到欠货款=Collected Debt
记20=Records of 20
笔记本=Laptop
记25= Records of 25
请输入关联业务=Enter business type
按销售对账=Sales Reconciliation
按送货对账=Shipping Reconciliation
客户名称&nbsp;&nbsp;&nbsp;=Customer Name
展开款项=Expand payment
隐藏款项=Hide payment
顺序=Descending order
箱数=Carton Qty
销售明细=Sales details
今日销售量=Sales Qty
昨日销售量=Sales Qty
本月销售量=Sales Qty
今年销售量=Sales Qty
总额=Total Amount
请输入销售单号=Enter SO No.
送货日期&nbsp;&nbsp;&nbsp;=Delivery Date
接收邮箱=receive email
盈余明细=Surplus Details
今日毛利=Gross Profit
昨日毛利=Gross Profit
本年毛利=Gross Profit
总毛利=Total Gross Profit
日期&nbsp;&nbsp;&nbsp;=Date
显示=Show
隐藏=Hide
当月结余=Balance
累计结余=Accumulated balance
显示送货统计=Display shipping statistics
隐藏送货统计=Hide shipping statistics
销售数量&nbsp;&nbsp;&nbsp;=Sales Qty
送货数量&nbsp;&nbsp;&nbsp;=Delivered Qty
退货数量&nbsp;&nbsp;&nbsp;=Refund Qty
实际销售&nbsp;&nbsp;&nbsp;=Actual Sales
实际送货&nbsp;&nbsp;&nbsp;=Actual Delivered
销售额&nbsp;&nbsp;&nbsp;=Sales Amt
送货额&nbsp;&nbsp;&nbsp;=Delivered Amt
成本单价&nbsp;&nbsp;&nbsp;=Unit Cost
毛利&nbsp;&nbsp;&nbsp;=Gross Profit
按销售金额计算=By sales amount
按送货金额计算=By delivered amount
占比&nbsp;&nbsp;&nbsp;=Proportion
采购汇总=Purchase summary
今日合同额=Sales Amount
昨日合同额=Sales Amount
本月合同额=Sales Amount
今年合同额=Sales Amount
未收数量=Qty to be received
请输入采购单号=Enter purchase no
收货日期&nbsp;&nbsp;&nbsp;
它就是商户销售的流水账噢，完全按时间的发生顺序统计销售额、成本价、毛利的账本哦=It is the running account of the vendor's sales, and the sales, cost, and gross profit books are counted in the order of time.
它就是商户采购的流水账噢，完全按时间的发生顺序统计采购额、采购明细的账本哦=It is the running account of vendors' purchases, and the bills of purchases and purchase details are counted completely in the order of time.
在这里是按照销售排名排列，可以看到所有产品的销售排名、销售占比、毛利哦=Here is ranked by sales ranking, you can see the sales ranking, sales ratio, gross profit of all items.
这里是按计划送货日期显示的，总览商户每天需要送出的货品明细，以及整个送货明细的历史哦=Here is the date of delivery according to the plan, the overview of the goods that the merchant needs to send every day, and the history of the entire delivery details.
这里是按计划收货日期显示的，总览商户每天需要收到的货品明细，以及整个收货明细的历史哦=Here is the date of receipt of the plan, the overview of the goods that the merchant needs to receive every day, and the history of the entire receipt details.
在这里可以看到，与商户发生交易的所有客户的销售额汇总，以及发生交易产生的欠款汇总的数据呢=Here you can see the sales summary of all the customers who have traded with the merchant, and the data of the arrears generated by the transaction.
在这里可以看到，与商户发生交易的所有供应商的采购额汇总，以及商户各种费用支出汇总、发生交易产生的未付款汇总的数据呢=Here you can see the sum of the purchases of all the vendors that have traded with the merchants, as well as the summary of the various expenses of the merchants, and the unpaid summary data generated by the transactions.
这里是根据送货日志抓取的，总览商户每天送出的货品明细、地址区间哦=Here is the item details and address range that the merchants send out every day according to the delivery log.
这里是根据收货日志抓取的，总览商户每天入库的货品明细、地址区间哦=Here is the item list and address range that the merchants are warehousing every day according to the receipt log.
销售业绩表=Sales Performance by Staff
这是统计、显示有销售行为的员工的具体的，每月的销售总额、回款总额、费用花销、业绩净额以及应催款总额的报表=This is the specific, monthly total sales, total payment, cost of expenses, net performance, and total amount of dunnable funds.
这里统计的是您商户，各个年度的结余利润，以及具体每个月份的收入、支出、利润的汇总数据哦=Here is the summary of your business, the balance of profits for each year, and the specific data of income, expenses, and profits for each month.
这是按日期统计、显示的，商户的整个销售流水-资金总收入的明细的报表喔=This is a breakdown of the total sales flow of the merchant - the total income of the funds by the date statistics, display.
这是按日期统计、显示的，商户的整个采购流水或者费用支出流水-资金总支出的明细的报表喔=This is a breakdown of the statistics of the business, the entire purchase flow of the merchant, or the breakdown of the total expenditure of the funds.
这是按销售日期或送货日期统计的，您可以查看或打印单个客户的销售明细和欠款状态完成阶段性对账=This is calculated by sales date or delivery date. You can view or print the sales details and arrears status of individual customers to complete the phased reconciliation.
这是按采购日期或收货日期统计的，您可以查看或打印单个供应商的采购明细和付款状态，完成阶段性对账=This is based on the purchase date or the date of receipt. You can view or print the purchase details and payment status of a single vendor to complete the staged reconciliation.
这是根据销售退货日期统计的，您可以查看、打印或导出具体退货明细及汇总，并关联相关业务=This is based on the sales return date, which allows you to view, print or export specific return details and summaries, and correlate related business
这是根据采购退货日期统计的，您可以查看、打印或导出具体退货明细及汇总，并关联相关业务=This is based on the date of purchase return, you can view, print or export specific return details and summary, and related business
销售汇总=Sales Summary
业务人员=Salesman
销售业绩报表=Sales (Performance) Reports
展开=Expand
费用=Cost
业绩净额=Performance
请输入销售退货单号=Enter sales refund number
按采购对账=Purchase Reconciliation
按收货对账=Goods Receipt Reconciliation
供应商名称&nbsp;&nbsp;&nbsp;=Vendor Name
采购明细=Purchase details
今日采购量=Purchase Qty
昨日采购量=Purchase Qty
本月采购量=Purchase Qty
今年采购量=Purchase Qty
流水单号=Transaction Ref.
员工=Staff
产品信息=item message
公式：库存数量=Formula: stock
，金额：=, Amt.
条形码=Bar code
销售折扣=Sales Discount
启用多单位=Set the Unit
同步到商户设置-统一规格型号=Sync to Settings
同步到商户设置-统一颜色=Save to Colour List
标签=Tag
导入=Import
未完成=Incomplete
新增流水=New Trans.
批&nbsp;量&nbsp;导&nbsp;入=Import
下&nbsp;载&nbsp;模&nbsp;板=Download Template
批&nbsp;量&nbsp;导&nbsp;出=Export
批&nbsp;量&nbsp;打&nbsp;印=Print
输入单号查找=Search by Document No.
产品标签=item Tag
盘点库存=Stocktake
修改均价=Adjust Average Cost
上传数据=upload data
期初/盘点=Opening/counting
选择操作仓库=Select an operation warehouse
选择操作分类=Select operation classification
下载库存模板=Download inventory template
下载商品库存数据=Download item inventory data
上传库存模板=Upload inventory template
期初/盘点成功=Beginning/counting succeed
新建付款单=New Expense
种类一=Type 1
种类二=Type 2
导入产品=Import
导出产品=Export
添加标签=Add Tag
确认添加=Confirm addition
批量添加产品标签=Add item tags in batch
快速添加产品标签)=Quickly add item tags) 
分类=Type
批量操作&nbsp;=Batch Actions
销售、送货单号=Sales Order & Delivery Order No.
系统消息=System message
实存数量=Actual Qty
种类=Type
产品编码=SKU
产品条形码=Item bar code
销售信息=Sales info
确认更新=Confirm update
输入产品名、规格或颜色=enter item name, dimension or colour
高频操作=Frequent Actions
行业信息=Industry Info.
打印信息=Print Info.
辅助资料=Supporting documents
英文名称=English Name
联系人=Contact Person
摊位号=Stall No.
号=No.
行业属性=Industry
业务属性=Operations
欠款按合同金额统计=Arrears based on Sales 
欠款按送货金额统计=Arrears based on Delivery 
分仓管理=Warehouse Management
销售单快速采购=Generate PO from SO
自定义单据公式=Set custom formula
自定义单号=Custom Document No.
货品属性=Item Attributes
统一=Standard
细码=Size
扫码开单=Scan barcode
显示库存数量=Show Inventory Qty
打印预览=Print Preview
自定义列宽=Custom column width
选择行业属性=Select Industry info
选择业务属性=Operations Selector
以下选择框，可以根据您业务模式，自定义数据的统计方式、业务模块=You can make  customized data statistics and business modules based on your business model.
选择后，销售单、采购单等业务数据会相应改变哦=SO, PO and business documents will be changed after this operation.
选择货品属性=Select item attributes
属性支持多选=Multi-selection allowed
自定义您的产品、单据等模块，定制统计=Customize based on your item, documents modules and statistics 
影响产品，单据界面属性：=Changes made will affect item and order attributes:
设置统一规格=Standard Dimensions
设置统一颜色=Standard Colours
自定义装箱字段=Custom Packing
统一单位=Standard Units
仅影响单据界面属性：=Impacts document display
设置规格型号统一模板=Set standard dimension template
此模版仅覆盖新增产品=This template only applies to new items.
单个产品新增、编辑、删除规格不影响模版=New items, edit, deletion will not impact templates.
设置颜色统一模板=Standard Dimensions - Template
单个产品新增、编辑、删除颜色不影响模版=Single item add, edit,  colour deletion will not impact templates.
设置重量单位=Set Wt. 
整箱计重：未装箱时，单据中重量列为每行产品总重量=FCL WT.: When not in carton, the wt in the document is listed as the total wt of each line.
单位=Units
计量方式=Measuring Method
单个产品=Per item
整箱计算=Count in Carton
设置打印条款=Set printing T&Cs
此模板是打印订单显示相关的条款，可以编辑和删除，编辑后，打印出来的相关条款，以用户编辑的界面和字段为准=This template is the relevant terms of the print order display, can be edited and deleted, edited, printed out the relevant terms, subject to the user edited interface and field.
自定义字段会替换总箱数、每箱数量字段并同步到打印中=The custom field replaces the total number of boxes, the number of boxes per box field and syncs to print.
自定义中文字段=Customize CN text
打印英文=Print in EN
设置外箱尺寸=Set Carton Size
设置规格在单据输入方式=Set enter method of dimension
根据自己的使用习惯，自定义在单据界面输入选择的方式=Customize the way to enter selections on the document interface according to your own usage habits.
弹框选择输入=Pop-up to select
下拉框选择输入=Drop-down to select
设置颜色在单据输入方式=Set colour entry method
保存并预览=Save and Preview
风险提示=Caution
&nbsp;&nbsp;&nbsp;&nbsp;您好，更换统计欠款方式属于高危操作，在操作前请仔细阅读下述风险提示内容：=Hello, replacing the statistical arrears is a high-risk operation. Please read the following risk warning contents carefully before operation:
&nbsp;&nbsp;&nbsp;&nbsp;1）此次变更涉及到客户、供应商欠款的金额统计变更=1) This involves changes in the amount of money owed by customers and vendors.
&nbsp;&nbsp;&nbsp;&nbsp;2）统计模式更改后，所有单据（老单子以及新增单子）全部按照最新的统计方式进行重新统计=2) After the statistical mode is changed, all the documents (old orders and new orders) are re-stated according to the latest statistical methods.
&nbsp;&nbsp;&nbsp;&nbsp;3）老单据状态有一定几率会更改，例如有全部收款，变更为超收款等=3) The old document status has a certain chance to change, for example, all collections are changed to overpayments, etc.
&nbsp;&nbsp;&nbsp;&nbsp;您好，关闭=Hello, Close
属于危险操作，在操作前请仔细阅读下述风险提示内容：=It is a high-risk operation. Please read the following risk warning contents carefully before operation:
已有业务数据，继续关闭，数据将会被隐藏=Business data exsits. If continue to close, data will be hidden.
&nbsp;&nbsp;&nbsp;&nbsp;2）关闭期间，不能新增=2) Cannot be added during shutdown
单据=Document
&nbsp;&nbsp;&nbsp;&nbsp;1）关闭分仓管理后，默认仓库对应的库存数量会被继续使用=1) After closing the warehouse management, the inventory quantity corresponding to the default warehouse will continue to be used.
&nbsp;&nbsp;&nbsp;&nbsp;2）关闭分仓管理后，其他仓库对应的产品库存数量整体被隐藏，不可以再次使用，请在关闭前调入默认仓库=2) After closing the warehouse management, the inventory quantity of the corresponding warehouses of other warehouses is hidden as a whole and cannot be used again. Please transfer to the default warehouse before closing.
&nbsp;&nbsp;&nbsp;&nbsp;3）关闭分仓管理后，仓库对应的老单子，可以继续查看，编辑和打印=3) After closing the warehouse management, the old order corresponding to the warehouse can continue to view, edit and print.
&nbsp;&nbsp;&nbsp;&nbsp;4）关闭分仓管理后，新增单子不可以再次选择仓库=4) After closing the warehouse management, the new order cannot be selected again.
&nbsp;&nbsp;&nbsp;&nbsp;5）关闭分仓管理只是隐藏仓库管理列表，不执行删除操作，再次打开会全部显示=5) Close the warehouse management is just to hide the warehouse management list, do not perform the delete operation, will be displayed again when you open it again.
&nbsp;&nbsp;&nbsp;&nbsp;您好，关闭单位属于高危操作，在操作前请仔细阅读下述风险提示内容：=Hello, shutting down the unit is a high-risk operation. Please read the following risk warning contents carefully before operation:
&nbsp;&nbsp;&nbsp;&nbsp;1）单位对应的产品属性：原售价、进价信息比例等全部清空（隐藏），其对应产品价格信息全部初始为最小单位对应的价格=1) The item attributes corresponding to the unit: the original selling price, the price information ratio, etc. are all cleared (hidden), and the corresponding item price information is initially the price corresponding to the smallest unit.
&nbsp;&nbsp;&nbsp;&nbsp;2）单位对应的老单子，可以正常查看、编辑和打印=2) The old order corresponding to the unit can be viewed, edited and printed normally.
&nbsp;&nbsp;&nbsp;&nbsp;3）单位对应的均价会保留最小单位的均价到产品上=3) The average price corresponding to the unit will retain the average price of the smallest unit to the item.
&nbsp;&nbsp;&nbsp;&nbsp;4）单位关闭只是隐藏单位，不执行删除操作=4) Unit close is just a hidden unit, no delete operation
再次打开会全部显示，若想删除单位，请点击删除按钮，执行删除操作=Open again will display all, if you want to delete the unit, please click the delete button to perform the delete operation.
权限明细=Permission Details
&nbsp;&nbsp;&nbsp;&nbsp;&nbsp;&nbsp;系统最高权限者，可以操作所有功能，更改其他角色权限=The highest permission of the system, you can operate all functions, change other role permissions.
投资人员=Investors
&nbsp;&nbsp;&nbsp;&nbsp;&nbsp;&nbsp;拥有所有数据的查看权限=Can view access all data.
客户权限=Customer Permission
查看自己新增客户=View own customers
查看所有客户=View all customers
批量导出客户数据=Export customers
编辑自己新增客户=Edit own customers
编辑所有客户=Edit all customers
删除(禁用)自己新增客户=Delete or suspend own customers
删除(禁用)所有客户=Delete or suspend all customers
单据权限=Operational Permission
查看自己新增销售单=View own SOs
查看所有销售单=View all SOs
编辑自己新增销售单=Edit own SOs
编辑所有销售单=Edit all SOs
批量导出(打印)单据数据=Export (Print) SOs
拒收自己新增销售单=Refund own SOs
拒收所有销售单=Refund all SOs
删除自己新增销售单=Delete own SOs
删除所有销售单=Delete all SOs
新增销售退货单=Create new Sales Return
查看自己新增销售退货单=View own Sales Returns
查看所有销售退货单=View all Sales Returns
编辑自己新增销售退货单=Edit own Sales Returns
编辑所有的销售退货单=Edit all Sales Returns
允许冲销欠款=Allow write-off
删除自己新增销售退货单=Delete own Sales Returns
删除所有销售退货单=Delete all Sales Returns
产品权限=Item Permission
新增产品=Create new item
产品合并=Merge items
查看自己新增产品=View own items
查看所有产品=View all items
编辑自己新增产品=Edit  own items
编辑所有产品=Edit all items
删除(禁用)自己新增产品=Delete or suspend own items
删除(禁用)所有产品=Delete or suspend all items
查看产品进价=View Purchase Price
编辑产品进价=Edit Purchase Price
查看产品售价=View Sales price
编辑产品售价=Edit Sales Price
编辑产品期初库存=Edit Opening Stock
批量导出产品数据=Export items
查看销售折扣=View Sales Discount
编辑销售折扣=Edit Sales Discount
库存权限=Inventory Permission
查看库存汇总数量=View Total Qty
查看库存汇总价格=View Total cost
批量导出库存数据=Export inventory
编辑库存数量=Edit Inventory
查看库存均价=View Average Cost
编辑库存均价=Edit Average Cost
批量导出(打印)销售单据=Export (print) SOs
查看自己新建销售退货单=View own sales refund orders
供应商权限=Vendor Permission
查看自己新增供应商=View own vendors
查看所有供应商=View all vendors
批量导出供应数据=Export vendors
编辑自己新增供应商=Edit own vendors
编辑所有供应商=Edit all vendors
删除(禁用)自己新增供应商=Delete or suspend own vendors
删除(禁用)所有供应商=Delete or suspend all vendors
新增采购单=Create PO
查看自己新增采购单 =View own new purchase order
查看所有采购单=View all purchase orders
编辑自己新增采购单=Edit own new purchase order
编辑所有采购单=Edit all purchase orders
删除自己新增采购单=Delete own new purchase order
删除所有采购单=Delete all purchase orders
批量导出(打印)采购单据=Group export (print) purchase documents
新增采购退货单=New purchase return form
查看自己新增采购退货单=View own new purchase and return receipts
查看所有采购退货单=View all purchase return receipts
编辑自己新增采购退货单=Edit own new purchase returns
编辑所有的采购退货单=Edit all purchase and return orders
删除自己新增采购退货单=Delete own new purchase return
删除所有采购退货单=Delete all purchase returns
删除（禁用）自己新增产品=Delete (Suspend) your new product
删除（禁用）所有产品=Delete (Suspend) all products
编辑送货(收货)单=Edit the delivery (receiving) note
删除送货(收货)单=Delete the delivery (receiving) note
拒收送货单=Rejected delivery note
批量导出（打印）单据=Group export (print) documents
查看送货(收货)金额=View the delivery (receiving) amount
查看销售(采购)退货金额=View the amount of sales (purchases) returned
编辑销售(采购)退货单=Edit sales (purchase) returns
删除销售(采购)退货单=Delete sales (purchases) returns
查看全部调拨单=View all allocation notes
查看自己调拨单=View own allocation notes
编辑全部调拨单=Edit all allocation notes
编辑自己调拨单=Edit own allocation notes
删除全部调拨单=Delete all allocation notes
删除自己调拨单=Edit own allocation notes
查看全部仓库=View all warehouses
查看自己仓库=View own warehouses
编辑全部仓库=Edit all warehouses
编辑自己仓库=Edit own warehouses
禁用(启用)、删除全部仓库=Suspend (enable) and delete all warehouses
禁用(启用)、删除自己仓库=Suspend (enable) and delete own warehouses
报表权限=Reports Permission
输入用户名查找=Search by Username
添加用户=New User
设置角色权限=User Control
请输入用户名=Enter username
确认密码=Confirm Password
请再次输入密码=Re-enter password
请输入姓名=Enter name
性别=Gender
请输入性别=Enter gender
请输入手机号码=Enter contact no.
电子邮箱=Email
请输入电子邮箱=Enter email address
职位=Occupation
请输入职位=Enter occupation
保存并分配角色=Save and Assign Role

国际地区=International area
国家=Country
阿尔巴尼亚=Albania
阿尔及利亚=Algeria
阿富汗=Afghanistan
阿根廷=Argentina
阿拉伯联合酋长国=United Arab Emirates
阿曼=Oman
阿塞拜疆=Azerbaijan
埃塞俄比亚=Ethiopia
埃及=Egypt
爱尔兰=Ireland
爱沙尼亚=Estonia
安道尔=Andorra
安哥拉=Angola
安提瓜和巴布达=Antigua and Barbuda
奥地利=Austria
澳大利亚=Australia
巴巴多斯=Barbados
巴布亚新几内亚=Papua New Guinea
巴哈马=Bahamas
巴拉圭=Paraguay
巴勒斯坦=Palestine
巴林=Bahrain
巴拿马=Panama
巴基斯坦=Pakistan
巴西=Brazil
白俄罗斯=Belarus
保加利亚=Bulgaria
贝宁=Benin
比利时=Belgium
秘鲁=Peru
冰岛=Iceland
布基纳法索=Burkina Faso
布隆迪=Burundi
不丹=Bhutan
博茨瓦纳=Botswana
玻利维亚=Bolivia
波兰=Poland
伯利兹=Belize
波斯尼亚和黑塞哥维那=Bosnia and Herzegovina
朝鲜=Korea
赤道几内亚=Equatorial Guinea
丹麦=Denmark
德国=Germany
多哥=Togo
多米尼加共和国=Dominican Republic
多米尼克=Dominic
东帝汶=Dominic
俄罗斯=Russia
厄瓜多尔=Ecuador
厄立特里亚=Eritrea
法国=France
梵蒂冈（教廷）=Vatican City
菲律宾=Philippines
斐济=Fiji
芬兰=Finland
佛得角=Cape Verde
冈比亚=Gambia
刚果（布）=Democratic Republic of Congo
刚果（金）=Rebublic of Congo
哥伦比亚=Colombia
哥斯达黎加=Costa Rica
格林纳达=Grenada
格鲁吉亚=Georgia
古巴=Cuba
圭亚那=Guyana
哈萨克斯坦=Kazakhstan
海地=Haiti
韩国=Korea
荷兰=Netherlands
黑山=Montenegro
洪都拉斯=Honduras
吉布提=Djibouti
吉尔吉斯斯坦=Kyrgyzstan 
基里巴斯=Kiribati 
几内亚=Guinea 
几内亚比绍=Guinea-Bissau
加纳=Ghana 
加拿大=Canada
加蓬=Gabon 
柬埔寨=Cambodia 
捷克=Czech Republic 
津巴布韦=Zimbabwe
喀麦隆=Cameroon
卡塔尔=Qatar
科摩罗=Comoros
科特迪瓦=Cote d'Ivoire
科威特=Kuwait
克罗地亚=Croatia
肯尼亚=Kenya
库克群岛=Cook Islands
拉脱维亚=Latvia
莱索托=Lesotho
老挝=Laos
利比亚=Libya
利比里亚=Liberia
黎巴嫩=Lebanon
立陶宛=Lithuania
列支敦士登=Liechtenstein
卢森堡=Luxembourg
卢旺达=Rwanda
罗马尼亚=Romania
马达加斯加=Madagascar
马尔代夫=Maldives
马耳他=Malta
马拉维=Malawi
马来西亚=Malaysia
马里=Mali
马其顿=Macedonia
马绍尔群岛共和国=Republic of the Marshall Islands
毛里塔尼亚=Mauritania
毛里求斯=Mauritius
美国=United States of America
蒙古=Mongolia
孟加拉国=Bangladesh
密克罗尼西亚联邦=Federated States of Micronesia
缅甸=Myanmar
墨西哥=Mexico
摩尔多瓦=Moldova
摩洛哥=Morocco
摩纳哥=Monaco
莫桑比克=Mozambique
纳米比亚=Namibia
瑙鲁=Nauru
南非=South Africa
南苏丹=South Sudan
尼泊尔=Nepal
尼加拉瓜=Nicaragua
尼日尔=Niger
尼日利亚=Nigeria
纽埃=Niue
挪威=Norway
帕劳=Palau
葡萄牙=Portugal
日本=Japan
瑞典=Sweden
瑞士=Switzerland
萨尔瓦多=El Salvador
萨摩亚=Samoa
沙特阿拉伯=Saudi Arabia
塞尔维亚=Serbia
塞拉利昂=Sierra Leone
塞内加尔=Senegal
塞舌尔=Seychelles
塞浦路斯=Cyprus
斯里兰卡=Sri Lanka
斯洛伐克=Slovakia
斯洛文尼亚=Slovenia
斯威士兰=Swaziland
苏里南=Suriname
苏丹=Sudan
索马里=Somalia
所罗门群岛=Solomon Islands
圣多美和普林西比=Sao Tome and Principe
圣基茨和尼维斯=Saint Kitts and Nevis
圣卢西亚=Saint Lucia
圣马力诺=San Marino
圣文森特和格林纳丁斯=Saint Vincent and the Grenadine
塔吉克斯坦=Tajikistan
泰国=Thailand
坦桑尼亚=Tanzania
汤加=Tonga
土耳其=Turkey
土库曼斯坦=Turkmenistan
突尼斯=Tunisia
图瓦卢=Tuvalu
特立尼达和多巴哥=Trinidad and Tobago
瓦努阿图=Vanuatu
委内瑞拉=Venezuela
危地马拉=Guatemala
文莱=Brunei
乌干达=Uganda
乌克兰=Ukraine
乌拉圭=Uruguay
乌兹别克斯坦=Uzbekistan
西班牙=Spain
希腊=Greece
匈牙利=Hungary
新加坡=Singapore
新西兰=New Zealand
叙利亚=Syria
牙买加=Jamaica
亚美尼亚=Armenia
也门=Yemen
意大利=Italy
伊拉克=Iraq
伊朗=Iran
以色列=Israel
印度=India
印度尼西亚=Indonesia
英国=United Kingdom
越南=Vietnam
约旦=Jordan
赞比亚=Zambia
乍得=Chad
智利=Chile
中非=Central Africa


加工单=Process Order
物流单=Logistics Order
编辑加工公司=Edit process company
请选择加工公司=Please select process company
加工公司=process company
请输入或选择加工公司=Please type in or select process company
已有=Existed
存在，但是被禁用，请开启后使用=The item is existed but has been banned previously, please open it and try again.
未收款(累计欠款：=Uncollected(accumulate arrears:
未付款(累计欠款：=Unpaid(accumulate arrears:
，超过订单总额50=,50 more than total amount of the order
有效时间：=Effective time:
（客户）=(Customer)
（供应商）=(Vendor)
已支付未发货=Paid but undelivered
您已打开严格进销存，不允许进行此操作=You have opened strict distribution mode, can not proceed this action.
检测到账号{$1}进行了商户设置的变更操作：{$2}，此时您还处在未变更状态，继续操作会有可能制造错误数据，是否立即刷新，更新商户设置？=Detected that account {$1} has made changes in business owner settings:{$2}, currently you have not sync to these changes. Keep operating might cause some error data, do you want to refresh now and update the business owner settings?
温馨提示:=Tips:
立即刷新=Refresh now
忽略消息=Ignore notification
检测到当前表格有缓存数据未保存，是否恢复此数据？There are still some cache data hasn't saved yet, do you want to recover it?
整=integer
(/(零=(/(zero
零$/,=zero$/,
确认把选择入库的产品全部同步到加工出库明细，出库的数量根据入库数量加上损耗的数量计算=Please confirm that all the stock-in product will be synced to stock-out details. The estimated stock-out amount will be stock-in amount plus losses.
注：每单仅可以点击一次一键加工，请确认需要加工的产品已经全部输入=Note: You can use one click process in every stock-in detail once only, please confirm that all the products that need to be processed have been entered.
确认把选择的子产品按照产品组合信息的配比，组合为组合成品，成品的数量根据子产品的数量减去损耗的数量，然后除以组合比例计算，保留整数，若除不尽，组合成品数量则直接减少1=Please confirm that the selected sub product will be composited based on the ratio in product composite information. Product number will be sub products number minus losses, and then divide by group ratio, keep the integer. If there is remainder, then the composite products number will minus 1.
确认把所有的组合成品按照产品组合信息的配比拆卸为子产品，子产品的数量根据组合成品的数量乘以配比计算=Please confirm that all the composite product will be reassembled to sub product based on product composite information. The number of sub product will be composite product times group ratio.
注：每单入库明细仅可以点击一次一键拆卸，请确认需要拆卸的产品已经全部输入=Note: You can use one click disassembled in every stock-in detail once only, please confirm that all the products that need to be disassembled have been entered.
确认把选择出库的产品全部同步到加工入库明细，预估入库的数量根据出库数量减去损耗的数量计算=Please confirm that all the stock-out product will be synced to stock-in details. The estimated stock-in amount will be stock-out amount minus losses.
注：每单出库明细仅可以点击一次一键拆卸，请确认需要拆卸的产品已经全部输入=Note: You can use one click disassembled in every stock-out detail once only, please confirm that all the products that need to be disassembled have been entered.
抱歉，请至少选择2个产品=Sorry, please select at least two product
抱歉请选择至少一个入库产品=Sorry, please select at least one stock-in product
抱歉请选择至少一个出库产品=Sorry, please select at least one stock-out product
一键组合=One click composite
抱歉，选择的子产品列表不符合任意一个组合成品的子产品配比，请修改=Sorry, selected sub product list does not match any composite product's sub product ratio, please amend.
条形码只能输入数字、字母=The bar code can only include number and alphabet.
抱歉，请选择可以导出的项哦=Sorry, please select the items that can be exported
草稿、快捷单据等都是不可以导出的=Draft and quick order can not export.
草稿、快捷单据等都是不可以导出的,已经被过滤=Draft and quick order can not export, they have been removed from the list.
密码输入有误，请重新填写=The password is invalid, please try again.
自=Self
垫=Advance
亲，该单据没有非产品费用哦=Sorry, this order does not have no product expenses.
支付账户至少保留一个=Please keep at least one payment account
编辑产品分类=Edit product classification
您好，删除分类属于高危操作，在操作前请仔细阅读下述风险提示内容：=Hello, to delete a classify is dangerous, please read the warning information below before proceed.
1）删除分类后，此分类对应的产品全部归为未分类，同时参与销售、参与采购=1）After delete this classify, all the product inside will be classified as unclassified. It will be used by Sales and Purchase at the same time.
确定删除该分类吗？=Please confirm to delete this classify.
请输入验证码=Please type in OTP
短信验证码=Msg OTP
短信验证码不能为空=The Msg OTP can not be empty
物流单号:=Logistics order number:
物流商:=Logistics vendor:
卸货网点:=Unload place
电话:=Contact number
预计到货时间:=Estimated delivery time
已支付已取消=Paid has been canceled
已退款已取消=Refunded has been canceled
已支付已拒收=Paid has been rejected
已退款已拒收=Refunded has been rejected
已支付=Paid
将送货方式更改为=Change the delivery method to
物流配送=Logistic delivery
，即可进行自助下单发货，我们会上门提货哦=, then can create order automatically, we will provide home delivery.
匹)=Pieces)
出=Out
均价=Average Price
入=In
调拨=Requisition
预估入库数量=Estimated stock-in number
入库产品=Stock-in product
入库规格=Stock-in spec
入库颜色=Stock-in color
加工单价=Process price
成本单价=Cost price
预估入库=Estimated stock-in
出库数量=Stock-out quantity
出库产品=Stock-out product
出库规格=Stock-out spec
出库颜色=Stock-out color
子产品=Sub product
提示：抱歉，组合产品和子产品不可以相同，请修改=Tips: sorry, the composite product can not be the same as sub product, please amend
组合比例=Group Ratio
缸号=Batch no.
请选择缸号=Please select batch no.
匹数=Quantity of pieces 
匹=Pieces
精细管理每一匹布=Detailed management of each pieces of cloth
请选择细码数量=Please select textile specification quantity
预估=Estimation
库=Stock
损耗率=Loss rate
成本:=Cost:
传入后台的总金额=The total amount that has been sent to backstage
预估出库总金额=Estimated stock-out total amount
组合售价=Composite selling price
组合进价=Composite purchasing price
已收送货待收送货按箱数总金额=The total amount of delivered and delivering by cartons
关联销售单详情 子产品详情=Matching sales order detail - details of sub product
关联销售退货单详情 子产品详情=Matching sales return order detail - details of sub product
单位组=Group of unit
是否是多单位=If it is a multi-unit
缸号数组=Group of batch no.
是否是子产品=If it is a sub product
加工单出库明细入库明细对应关系 新建编辑需要传 只有加工单使用=Process order matching with stock-out details, need to upload new setting, only used in process order
加工单关联销售采购单详情=Process order matching sales order and purchase order
加工单关联销售采购单详情 子产品详情=Process order matching sales order and purchase order
批量=Bunch
细码计算方式=The method used to calculate textile specification
第{$1}行公式使用错误，被除数不能为0=Can not proceed the formula in row {$1}, the divisor can not be zero.
第{$1}行请重新选择产品=Please select the product again in row {$1}
第{$1}行产品只能是下拉框里面的=In row {$1} you can only select the products in the list.
第{$1}行组合比例必须为正数=The group ratio in row {$1} has to be integer.
抱歉，组合产品至少由2个子产品组成=Sorry, the composite product need at least two sub-product
抱歉，组合产品最多可以由100个子产品组成=Sorry, the sub products number of a composite product can not exceed 100
抱歉，该产品属于{$1}分类，不参与{$2},请去修改=Sorry, this product is under {$1} classify, can not be included in {$2}
供应商:=Vendor:
产品不存在=The product does not exist
0(0匹)=0(0 pieces)
(/规格/=(/spec/
格式图片=Property picture
第{$1}行产品不属于调出仓库 {$2}，确认要从 {$3} 调出吗？=The product in row {$1} does not belongs to output warehouse {$2}, do you want to get it from warehouse {$3}?
入库明细第{$1}行没有选择规格型号，=The details of stock-in don't have spec in row {$1}
出库明细第{$1}行没有选择规格型号，=The details of stock-out don't have spec in row {$1}
第{$1}行没有选择规格型号,=Please select the spec in row {$1}
入库明细第{$1}行没有选择颜色，=Please select color in row {$1} for stock-in details
出库明细第{$1}行没有选择颜色，=Please select color in row {$1} for stock-out details
第{$1}行没有选择颜色,=Please select color in row {$1}
确定保存吗？=Save?
该产品不存在，请添加此产品=The product does not exist, please add in the product
期初匹数=Opening pieces
细码传值给后台=Transport the textile to system
收支差=balance of income and expenditure
利润:=Profit:
物流提醒=Logistics alarm
此加工单已被删除=This process order has been deleted
此调拨单已被删除=This requisition order has been deleted
查看物流单=Check logistics order
产品详情不能为空=The breakdown of product can not be empty
编辑物流单=Edit logistics order
请选择调出仓库，不能和调入仓库相同=Please select stock-out warehouse, can not be the same as stock-in warehouse.
请选择调入仓库，不能和调出仓库相同=Please select stock-in warehouse, can not be the same as stock-out warehouse.
未加载成功,请刷新重试下哦=Loading unsuccessfully, please refresh and try again later
请选择发货地址=Please select shipper's address
重货=Heavy Cargo
泡货=Bulky Cargo
卸货网点1=Unload place
电话：=contact number:
距离送货地址：=Distance to receiver's address
请选择物流商=Please select logistic vendor
请与体积择一填写=Please do not fill in with the Volume at the same time
请与重量择一填写=Please do not fill in with the weight at the same time
货品名称不能为空哦=The cargos' name can not be empty
请填写箱数=Please fill in cartons' quantity
请完善地址 区不能为空=Please complete the address, city can not be empty
对不起，您所选择的物流路线尚未开通，敬请期待=Sorry, the logistics line that you choose has not opened yet, please wait.
卸货网点=Unload place
请勾选物流商和专线=Please select logistics vendor and logistics line
请先同意物流服务协议哦=Please agree logistics service agreement first.
订单已经接单并且支付了，确定要取消吗？=The order has been taken and paid, do you still want to cancel it?
订单已经取消,款项会在7个工作日内退回支付账户=The order has been canceled, refund will be finished in 7 days to the payment account.
密码错误,请重新输入哦=The password is invalid, please try again.
新建物流单=New logistics order
确认取消订单吗？=Do you want to cancel the order?
物流服务协议=Logistics service agreement
(费用垫付 {$1})=(Advanced payment {$1})
确认组合=Confirm the composite set
不能小于加工日期=Can not be smaller than the processing date
自行配送=Self delivery
(费用自付 {$1})=(Self payment {$1})
垫付=Advance payment
新建加工单=New process order
确定要删除此加工单吗？=Are you sure you want to delete this process order?
编辑加工单=Edit process order
草稿单直接进入编辑页面=Draft order to edit function directly
检测到该销售单有强关联对应的采购单,是否一起删除？=The system notice that there is a purchase order has strong relationship with this sales order, do you want to delete both order?
定制打印模板=Customized printing template
打印模板要求=Printing template requirement
单据模板：=Order template:
请选=Please select
请选择付款账户=Please select payment account
月份:=Month:
请选择收款账户=Please select collect account
请选择产品分类=Please select product type
请选择仓库=Please select warehouse
匹）=Pieces)
请选择公司名称=Please select company name
请选择制单人=Please select order creator
汇总=Summary
资金流水表=Fund Journal
请选择或输入仓库=Please select or type in the warehouse
上期累计=Accumulated amount from last period
(税额=(Tax amount
(优惠=(Discount
该邮件历史有问题，暂不能下载相应报表=The email history has an error, can not download required statement at the moment
物流单号=Logistics order number
物流公司=Logistics company
下单日期=Order created date
运单号=Order Number
已支付运输中=Paid order in transit
已支付正常签收=Paid order received correctly
已支付异常签收=Paid order received abnormally
请选择供应商名称或者电话=Please select vendor name or contact number
请选择状态=Please select status
实际应付:=Actual payment:
收货金额:=Collected amount:
已付款:=Paid:
未付款:=Unpaid:
超付款:=Overpaid:
实际应付：=Actual payable
加工流水=Process flow
直接销售=Direct sales
(费用自付=(Self payment
占比:=Percentage:
总未付:=Total unpaid amount:
欠款:=Arrears:
总欠款:=Total Arrears:
请选择在制单人=Please select order creator
请选择业务人员=Please select business people
请选择客户分类=Please select customer type
产品信息的组合产品名称不能为空=The composite product name in the product information can not be empty
新建产品分类=New product type
账户=Account
启用成功=Active successfully
启用失败=Active unsuccessfully
全部分类=All type
合并汇总=Summary
展开明细=Details breakdown
抱歉，匹数和库存数量正负不对应哦，请修改=Sorry, the pieces number and inventory number has to be in same signal, please amend
您修改匹数为0，意为盘亏，库存将删除这条记录=You have changed the pieces number to zero, which means you have lost all the inventory, the system will delete this record automatically.
您修改库存数量为0，意为盘亏，库存将删除这条记录=You have changed the inventory number to zero, which means you have lost all the inventory, the system will delete this record automatically.
您修改匹数为=You have changed the pieces number to
，库存数量为=, the inventory number is 
意为盘盈=Which means it's profitable
匹，库存将增加=Pieces, the inventory will increase
条正数记录=positive record
，意为盘盈=, which means it's profitable
匹,库存将增加=pieces, the inventory will increase
，意为盘亏=, which means it's losing
条负数记录=negative record
库存数量将变更为=The inventory quantity will become
您修改库存数量为=You have changed the inventory quantity to
，意为盘亏，库存将删除这条记录=, which means it's losing, the system will delete this record automatically
您修改匹数和库存数量为0，意为盘亏，库存将删除这条记录=You have changed the pieces number and inventory number to zero, which means it's losing, the system will delete this record automatically
匹数将变更为=The pieces number will changed to
（匹）,=(Pieces),
总匹数：=Total number of pieces:
（匹）=(Pieces)
（关联组合产品：=(Corresponding composite product:
查看加工单=Review process order
实际应付=Actual payable
产品分类=Product classification
修改商户设置=Edit business owner settings
登录地点=Log in place
设备类型=Device type
送货箱数=Delivering cartons number
收货箱数=Receive cartons number
已送箱数=Delivered cartons number
已收箱数=Received cartons number
选择细码模式=Please select textile specification mode
精细管理每一匹布，可以统计到库存一共几匹，每匹多少细码，总数多少=To precise manage every piece of cloth, included how many pieces in the inventory, how many textile specification each pieces of cloth has, what is the total amount.
选择组合模式:=Please choose the composite type:
选择库存减少或增加的统计方式=Please choose the way that how inventory increase or decrease
风险提示:=:Warning
确定(=Confirm(
送（收）货模块=Delivery (Receiving) Mode
(/、退货模块/=(/, Return mode/
(/送（收）货模块、/=(/Delivery (Receiving) Mode,/
(/模块/=(/Mode/
送（收）货=Delivery (Receiving)
设置单位在单据中的展示方式=Determine the way that unit displayed in orders
选择展示副单位，可以打印出来1箱2包3个，这样格式的多单位哦=Please select sub unit to display. Can print out multi-unit format such as 1 Cartons 2 Bag 3 Unit
账户余额=Account Balance
参与销售=Participate in sales
参与采购=Participate in purchase
1）关闭分仓管理后，默认仓库对应的库存数量会被继续使用=1)After close the warehouse management, will keep using inventory quantity for default warehouse 
2）关闭分仓管理后，其他仓库对应的产品库存数量整体被隐藏，不可以再次使用，请在关闭前调入默认仓库=2)After close the warehouse management, the inventory quantity in other warehouse will be hided and can not be reversed, please sync the data to default warehouse before doing so
3）关闭分仓管理后，仓库对应的老单子，可以继续查看、编辑和打印=3)After close the warehouse management, you can keep reviewing, editing and printing the Orders in corresponding warehouse.
4）关闭分仓管理后，新增单子不可以再次选择仓库=4)After close the warehouse management, new orders can not choose warehouse again
5）关闭分仓管理只是隐藏仓库列表，不执行删除操作=5)Closing the warehouse management is only hiding the list, but not delete it
;您好，关闭=;Hello, close
2属于高危操作，在操作前请仔细阅读下述风险提示内容：=2 has potentially high risk, please read the following tips of risk before action:
2对应的产品属性：期初库存、库存预警、每箱数量、外箱尺寸、售价、进价等全部清空（隐藏），其对应产品这些属性值全部初始为0（若打开=2 the products' property: Opening inventory, inventory warning, quantity of each cartons, size of the cartons, selling price, purchasing price will all be cleaned out (Hide), the corresponding property data will all be set as zero (If open
2之前有设置，则还原原值）=2 has data before, will revert to the previous data
2对应的库存数量会直接清空（隐藏），不承接在产品上，产品的库存数量会初始为0（若打开=2 corresponding inventory quantity will be cleaned out (Hide), and not accepting on the product. Opening balance of the inventory quantity will be zero (If open
2对应的均价会直接清空（隐藏），不承接在产品上，产品的均价会初始为0（若打开=2 corresponding average price will be cleaned out (Hide), and not accepting on the product. The average price of the product will be zero (If open
2关闭只是隐藏=2 Close is only hide
2，不执行删除操作=2, don't proceed the delete
再次打开会全部显示，若想删除=Reopen it will show all the information again, if you want to delete 
2，请去产品界面，点击删除（禁用）按钮删除（禁用）=2 please go to product detail pages, click delete (banned) button to delete (banned)
2属于危险操作，在操作前请仔细阅读下述风险提示内容：=2 has potentially high risk, please read the following tips of risk before action:
2已有业务数据，继续关闭，数据将会被隐藏=2 has business data, if you continue to close it, the data will be hide
;2）关闭期间，不能新增=;2) you can not create new while you closing it
2单据=2 Order
仅展示选中单位=Only display the selected unit
同时展示选中单位和副单位=Display selected unit and the sub unit
精细管理每一匹=Precise manage each piece of cloths
仅管理匹数和总数=Only manage the pieces and total amount
销售、采购按装箱=Sales, purchase will be by cartons
送货、收货按装箱=Delivery, receiving will be by cartons
您好，细码模式由=Hello, the textile specification is
更换为=Switching to
1）库存每一匹布的明细将会被=1)The details of each pieces of cloth in the inventory will be
，仅保留当前库存的匹数和总数量，再次打开也=, only keep the current inventory pieces number and total amount. When reopen it
不会恢复=it will not be recovered
2）产品界面匹数和期初库存明细也将会被=2) The pieces number in the product overview and details of opening inventory will be
，仅保留匹数和总数量，再次打开也=, only keep the pieces number and total amount. When reopen it
3）老单据正常状态=3)The standard status of previous order
不可以=Can not
编辑、拒收、生成采购单、复制新增、删除=edit, reject, create purchase order, copy and paste, and delete
仅可以=Only can
查看、新增销售单、打印、导出、发邮件、单独收付款和批量收付款=Review, create purchase order, printing, export, send email, make the payment or payment by bunch
再次打开也不可以编辑、删除等操作=Even reopen it, you still can not proceed actions such as edit, delete etc.
4）老单子草稿状态不可以生成销售单、编辑、保存，仅可以删除操作=4) The draft version of the previous order can not create sales order, edit, and save. Can only be deleted
1)库存界面的匹数和总数量数据将会被=1)The pieces number and total amount in the inventory overview will be
清空为0=Cleaned out to zero
，再次打开也=,when reopen it
并且清空数据操作需要时间处理，请耐心等待=The system is proceeding data cleaning now, please wait
2）产品界面匹数和期初库存也会被=2) The pieces number in product overview and opening inventory will be
库存日志界面=Inventory journal page
会记录本次清空操作，日志详情：=Will record this cleaning operation, the detail of the journal:
模式变更=Mode change
修改期初录入 出（入）库=Edit the opening record of stock-in(out) of inventory
，模式变更编辑出库=, change mode and edit stock-out
，模式变更编辑入库=, change mode and edit stock-in
4）老单据正常状态=4) Standard status of previous order
5）老单子草稿状态=5) Draft status of previous order
生成销售单、编辑、保存，=Create sales order, edit and save
删除操作=Delete
您好，=Hello,
关闭细码=Close textile specification
模式属于=Mode belongs to
高危操作=High risk action
，在操作前=, Before continuing
请仔细阅读下述风险提示内容：=Please read the tips of risk below carefully:
1）库存界面的匹数和明细将会被直接=1)The pieces number and details in inventory overview will be
2）产品界面匹数和明细将会被直接=2)The pieces number and details in product overview will be
4）老单子草稿状态=4)The draft status of previous order
开启细码=Open textile specification
，在操作前请仔细阅读下述风险提示内容：=, please read the tips of risk below carefully before continue:
库存界面=Inventory overview
产品的库存数量=Product quantity in inventory
0，匹数默认为=0, the default number of pieces
1，数量不变；若库存数量为0，则匹数为0=1, quantity remain unchanged; If inventory quantity is zero, then pieces number is zero
并且处理数据操作需要时间处理，请耐心等待=And the system need time to process the data, please wait.
2）开启=2) Open
产品界面期初库存数量=Opening inventory quantity in product overview
1，数量不变；若为0，则匹数为0，并且处理数据操作需要时间处理，请耐心等待=1, quantity remain the same; if it is zero, then the pieces number will be zero, and the system need time to process the data, please wait.
开启=Open
产品界面期初直接被清空为0，再次打开也不会恢复=The opening number in product overview will be cleaned out to zero, and it can not be recovered
组合产品开单增加、减少子产品库存=Increase product order, decrease sub product inventory
统计组合产品库存=Composite product inventory statistic
您好，关闭组合加工属于=Hello, to close the composite process is
危险操作=a high risk action
1）加工单已有业务数据，继续关闭，=1) Processing order has business data inside, to continue closing it,
数据将会被隐藏=the data will be hided
2）关闭期间，=2)While closing,
不能=can not
新增加工单，=create new processing order
销售单生成加工单=To create process order by using sales order
采购单生成加工单=To create process order by using purchase order
3）单据对应的子产品属性依旧保留，再次编辑依旧延续原组合加工的业务属性=3) The property of order, which come from sub product will remain the same. When you continue to edit it, it will keep using the business properties
您好，关闭组合加工属于危险操作，在操作前请仔细阅读下述风险提示内容：=Hello, to close a composite processing is a high risk action, please read the tips about risk below before action:
1）加工单已有业务数据，继续关闭，数据将会被隐藏=1) The process order has data inside, if you continue to close it, the data will be hided
2）关闭期间，不能新增加工单，不能销售单生成加工单，不能采购单生成加工单=2) You can not create new process order, and create the process order by sales order or purchase order while you closing it
秒账更新啦=Update
为此，系统将于2018年9月27日晚9点到12点进行版本迭代更新升级，届时将暂停服务，若给小主带来不便，望小主多多包涵哦=In that case, the system will update from 9:00pm to 12:00pm on 27th September 2018. The services will continue to be provided after that, we sincerely apologize for the inconvenience
(1) 新增组合加工功能，拆卸、组合、委外加工一键实现=(1) New composite process function: Now you can do disassembled， composite, and outsource processing by one click
(2) 完善折后价自由输入，折扣、单价智能反推=(2) Improve customized typing after discount, and reflect discount rate and price automatically
(3) 一键隐藏、展示0库存、负库存产品，存货分析更加具体=(3) Now you can analysis the stocks more precisely, to show 0 stock product, negative stock product and hide everything by one click
(4) 新增按业务汇总对账单模式，累计欠款一目了然=(4) You can learn the accumulated arrears at one glance by our brand new business statement
(5) 系统操作日志记录=(5) System operation journal record
和地址，风险监控更加强势=And address, the risk monitor can be more specific
更多精彩，敬请期待哦=Please look forward to more content
获取公众号授权=Authorization from WeChat subscription number
登录后开发者将获得以下权限=The developer can have the following permission after you log in:
获得你的公开信息（昵称、头像等）=To acquire your public information (Nickname, head sculpture）
确认授权=Confirm the authorization
缓存数据=Data cache
物流信息=Logistic information
运价查询=Check the transport fee
，帮您轻松解决=, help you to solve it easily
规格-颜色=Spec-color
新增产品分类=new product type
请输入产品分类名称=Please insert the name of the product type
产品类别名称中不能输入英文双引号=The name of the product can not include English double quotation mark
产品类别备注中不能输入英文双引号=The remark of the product can not include English double quotation mark
产品类别名称不能为=The name of the product can not be
选择=Please select
产品-组合信息=Product - Composite information
第{$1}行请输入组合比例=Please insert the group ratio in row {$1}
您好， 禁用规格属于高危操作，在操作前请仔细阅读下述风险提示内容：=Hello, to banned the spec is a high risk action, please read the tips of risk below carefully before you proceed:
1）规格对应的产品属性：期初库存、库存预警、每箱数量、外箱尺寸、售价、进价等全部清空（隐藏），不承接在产品上=1) The product properties: Opening inventory, inventory alert, quantity of each cartons, size of the cartons, selling price and purchasing price will be cleaned out (Hided), and will not be accepted on the product
2）规格对应的老单子，可以正常查看和打印，但是重新编辑会直接清空规格信息，并且不可以再次选择此规格=2)The previous order can be checked or printed, but it will be cleaned out when you edit it. And this can not recover
3）规格对应的库存数量会直接清空（隐藏），不承接在产品上=3)The inventory quantity will be cleaned out (Hided), and will not be accepted on the product
4）规格对应的均价会直接清空（隐藏），不承接在产品上=4)The average price will be cleaned out (Hided) , and will not be accepted on the product
5）规格对应的库存出库、入库日志在库存界面清空（隐藏），可以在产品库存明细里面点击查看=5) Stock-out inventory, and stock-in journal will be cleaned out at the inventory overview. However, you can check it in the details of product inventory
6）禁用后不可以新增同名称的规格，可以启用原规格=You can not create a spec by using the banned name, but you can reactivate the banned spec
2）规格对应的老单子，可以正常查看和打印，但是重新编辑会直接清空规格信息，并且不可以再次选择规格=2）The previous order can be checked or printed, but it will be cleaned out when you edit it. And this can not recover
1）被禁用的仓库，在单据界面不可以再次被选择到=1)The warehouse that has been banned can not be selected in the Orders
2）被禁用的仓库，涉及到的旧单子可以被正常查看、打印，但是编辑会清空仓库信息，可以重新选择=2)The previous order that related to the banned warehouse can be checked or printed, but it will be cleaned out when you edit it. And this can not recover
3）被禁用的仓库涉及到的产品库存数量，不能被再次使用，可以被调拨=3)The product inventory quantity that related to the banned warehouse can not be used again, but can be requisitioned
4）在库存界面搜索全部仓库的数量，不显示被禁用的仓库的产品数量，库存总数量、总价不统计被禁用的仓库库存数量和总价=4)When you searching the total number of the warehouse, it won't show the quantity of banned warehouse. And the total number of inventory, total amount will not included the banned warehouse stock
5）被禁用的仓库涉及到的产品没有被禁用=5)The product in the banned warehouse will not be banned
装箱和细码不能同时开启，开启装箱需先关闭细码=You can not open packing and textile specification at the same time. To open packing you need to close textile specification first
自定义模板=Custom template
下载打印模板=Download printing template
下载原始模板=Download original template
上传打印模板=Upload printing template
打印送货箱数=Print delivered cartons number
打印收货箱数=Print received cartons number
打印单位比例=Print unit ratio
打印缸号=Print batch no.
打印预估出库=Print estimated stock-out
打印子产品=Print sub product 
计价数量、预估出库同时打印=Print out pricing unit and estimated stock-out at the same time
打印物流信息=Print logistic information
打印预估入库=Print estimated stock-in
计价数量、预估入库同时打印=Print out pricing unit and estimated stock-in at the same time
抱歉，自定义打印模板是增值服务哦，需要去我的购买界面购买=Sorry, the custom template is value-added services, please purchase it in the store
智能记录=Intellectual record
账户总额:=Account balance:
属性=Property
描述=Description
分级设置=Setting by level
销售单、销售退货单界面的单价=The unit price in sales order and sales return order
跟随最新单据(同客户)=Follow the latest order (Same as customer)
跟随产品价格=Follow the product price
单据(同客户)和产品取最新更改价格=Order (Same as customers) and the product will use the latest price
采购单、采购退货单界面的进价以及销售单快捷采购进价=The price in purchase order, purchase return order and quick purchase order by sales order
跟随最新单据(同供应商)=Will follow the latest order (Same as vendor)
单据(同供应商)和产品取最新更改价格=Order (Same as vendor) and the product will use the latest price
组合单=Composite order
批量填写=Bunch insert
填写后,全部布匹的计价数量都会减去相同的=All the cloths price will remove the same part after you fill in.
/-,请谨慎填写=/-, Please fill in carefully
每匹=Every pieces
/-只能小于裁剪数量哦=/-Can only smaller than the cut number
/-只能小于细码哦=/-can only smaller than the textile specification
使用秒账物流，可免费上门取货=We will provide home delivery if you use BIZGO logistics
还享限时运费折扣=And enjoy discount on transport fee
我们还提供代发托运站服务=We will also provide stations to help you delivered the package
我知道了=Understood
不再提示=Do not show this again
您将离开秒账系统跳转到由第三方物流服务商提供的货运服务界面，为避免您重复录入，秒账系统将从您的单据中读取部分物流信息，填充物流界面=You are about to leave BIZGO and enter a logistics form provided by third party logistics vendor. To save your time, BIZGO will extract some logistics information from your order to fill up this form
不再弹出此框=Do not show this again
支付对象=Pay to
商家自付=Business Owner pay by themself
商家垫付=Business Owner pay by advance
费用类型=Type of the payment
请输入费用金额=Please type in the payment amount
请选择支付对象=Please select pay to whom
请选择或添加费用类型=Please select or type in the payment type
费用金额未填写哦，请填写=Please type in the payment amount
期初余额=Opening Balance
物流费用支付成功,祝商祺=The payment for logistics succeed, thank you
发货地址:=Departure address
送货地址:=Delivery address
货物属性:=Freight properties
货物信息:=Freight information
吨=Ton
以托运站最终验货后开单价格为准，多退少补=Will based on the final price when the freight has been received. Might need refund or additional payment
如需人工帮助，请致电0579-85059881，85059882=If you need help, please call 0579-85059881，85059882
预估运费=Estimated transport fee
一键下单=Create order by one click
请填写=Please fill in
选择邮件设置=Please select the settings for the email
工序名称=Flow name
新增加工工序=New process flow
编辑加工工序=Edit process flow
已存在，请重新输入=It's existed, please try again
选择产品=Please select product
搜索按钮点击后获取数据=Will acquire data once you click the "Search" button
搜索到的表格数据：=Form data
更新搜索到数据：=Update data
下拉框=Combobox
批量选择只能选中前100条哦，没有选中的需要手动勾选一下=The bunch selection will only include the first 100 items, please select the uncover items manually
输入产品=Input product
、货号=, freight no.
、规格=, spec
、颜色=, color
、条形码=, bar code
、缸号=, batch no.
查找=Search
加工数量=process number
（0匹）=(Zero Pieces)
发邮件成功=Sent successfully
客户名称:=Customer name:
箱)=Carton)
送货数量不能大于销售数量哦=The delivery amount can not exceed the sales amount
收货数量不能大于采购数量哦=The receiving amount can not exceed the purchase amount
操作失败=Action failed
灯饰配件=Lighting Accessories
家具家装=Furniture and home improvement
符合条件的产品列表：=Condition matching product list
选择需要组合的产品，可多选=Please select the product that need composite (Support multi-selection)
预估出库数量=Estimate stock-out amount
请选择产品哦=Please select product
快速输入细码=Please insert textile specification
请输入细码输入查找=Please search by typing in the textile specification
裁剪=Cut
总匹数：0匹 总数：0=Pieces total amount: 0 pieces Total amount: 0
销售匹数：0匹 计价数量：0=Sold pieces: 0 pieces Pricing unit: 0
若无库存，可以在此使用键盘=If the inventory does not exist, then can use keyboard here
请选择仓库名称=Please select warehouse name
请选择缸号名称=Please select batch no. name
输入不合法=The information is illegal
0（0匹）=0 (0 pieces)
(裁剪)=(Cut)
裁剪数量只能为正哦=The number to cut can only be positive
裁剪数量必须大于=The number to cut has to be larger than
/-哦=/-Oh
裁剪数量只能小于细码哦=The number to cut has to be smaller than textile specification
计价数量=Pricing unit
此使用键盘=Using keyboard here
总数：=Total amount:
匹数：=Pieces amount
数量：=Quantity
计价数量：=Pricing unit
库存明细最多加载2000匹，超过2000匹的部分通过缸号和细码查询=The detail of inventory will only include the first 2,000 pieces. For 2,001 and beyond, please use batch no. and textile specification to search
行细码弹框的细码详情：=The detail information in textile specification bullet box
参数：=Parameter:
细码数值不能小于等于每匹=The textile specification can not be less than each pieces
打钩裁剪后，输入框只可以输入一个细码=When you select "cut", the text box can insert one textile specification only
/-必须小于所选细码或裁剪=/-Has to less than selected textile specification or cut
选择送货细码=Please select delivery textile specification
销售匹数=Sold pieces
（裁剪）=（Cut)
是否裁剪=Do you want to cut?
检测到该布匹在本次=The selected piece is currently
货已被勾选，请重新选择其他布匹=The flight has been collected, please try again with other pieces
采购匹数=Purchase pieces number
入库数量=Stock-in quantity
选择收货细码=Please select receiving textile specification
细码不能超=The textile specification can not exceed
货，本次=Freight, currently
货更改=Freight has been changed
传统弹框=Traditional bullet box
货品名称=Freight name
发货地址=Departure address
物流商=Logistic vendor
预估到货时间=Estimated receiving time
拒收理由:=Reject reason
详细信息=Detail information
发货人=Shipper
预约发货时间=Estimated sending time
秒账优惠=BIZGO discount
注:以托运站最终验货后开单价格为准，多退少补=Note: Will based on final price, might have refund or additional payment
货物属性：=Freight properties
预估运费：=Estimated transportation fee
支付并提交订单=Pay and submit order
保存草稿=Save the draft
重新下单=Please order again
加工单号=Processing number
加工工序=Processing flow
加工日期=Processing date
计划入库日期=Estimated stock-in date
加工地址=Processing address
入库明细=Stock-in detail
一键拆卸=One click disassemble
一键加工=One click processing
自动抹零=Automatically rounded
出库明细=Stock-out detail
确定删除吗？=Do you sure to delete that?
退款账户=Refund account
送货方式=Delivery method
继续加工=Keep processing
生成加工单=Create processing order
今日支出:=Expenses today:
昨日支出:=Expenses yesterday:
本年支出:=Expenses this year:
总支出:=Total expenses:
今日收入:=Income today:
昨日收入:=Income yesterday:
本年收入:=Income this year:
总收入:=Total income:
单位:元=Yuan
结余=Balance
展示明细=Display details
汇总展示=Overview
类型=Type
未收款增加=Increase uncollected
未收款减少=Decrease uncollected
累计欠款=Accumulated arrears
今日销售金额:=Sales amount today:
昨日销售金额:=Sales amount yesterday:
本月销售金额:=Sales amount this month:
今年销售金额:=Sales amount this year:
今日毛利:=Profit today:
昨日毛利:=Profit yesterday:
本年毛利:=Profit this year:
总毛利:=Total profit:
加工单位=Processing unit
非子产品销售=No sub product sales 
子产品销售=Sub product sales
组合销售=Composite sales
实际销售=Actual sales
实际送货=Actual delivery
销售额=Sales amount
送货额=Delivery amount
退货占比=Return ratio
销售占比=Sales ratio
今日合同额:=Contract amount today:
昨日合同额:=Contract amount yesterday:
本月合同额:=Contract amount this month:
今年合同额:=Contract amount this year:
它就是商户加工的流水账噢，完全按时间的发生顺序统计加工明细的账本哦=It's the journal of business processing, will include all the processing details and sorted by time
这里，是把您的销售情况以客户分类，统计客户购买的每个产品的数量汇总的报表哦=This is the statement that shows you details of the customer purchasement
这里，是把您的采购情况以供应商分类，统计向供应商购买的每个产品的数量汇总的报表哦=This is the statement that shows you details of the vendor purchasement
这是按日期统计、显示的，商户资金总收入和资金总支出明细的报表喔=This is the statement that shows you total income and expenses, sorted by date
今日采购金额:=Purchase amount today:
昨日采购金额:=Purchase amount yesterday:
本月采购金额:=Purchase amount this month:
今年采购金额:=Purchase amount this year:
购买时长:=Purchase time length:
总金额 :=Total amount :
完善下列信息，购买后，可以联系秒账客服：400-0900-890，或联系在线客服=After you purchased and fill in the following information, you can contact BIZGO support at: 400-0900-890, or the online support
请输入电话=Please type in contact number
具体要求=Please type in specific request
请输入格式具体要求=Please type in format request
示例附件=Example attachment
组合信息=Composite information
查看禁用历史=Review banned history
禁用历史=Banned history
禁用规格=Banned spec
请输入规格或颜色=Please insert spec or color
禁用颜色=Banned color
组合产品=Composite product 
总匹数=Total pieces number
0的产品=0 product
布匹细码=Textile specification
严格进销存=Strikt distribution
售价不低于进价=Sales price should higher than purchase price
组合加工=Composite processing
秒账服务=BIZGO services
秒账物流=BIZGO logistics
选择秒账服务=Please select BIZGO services
单位:Unit:
计量方式:Calculation method
;您好，更换统计欠款方式属于高危操作，在操作前请仔细阅读下述风险提示内容：=;Hello, to change a arrears statistics method is a high risk action, please read the tips about risk below carefully before you proceed:
;1）此次变更涉及到客户、供应商欠款的金额统计变更=;1) This will change the arrears amount of customers and vendors
;2）统计模式更改后，所有单据（老单子以及新增单子）全部按照最新的统计方式进行重新统计;2) This will change all the orders (New and old) arrears
;3）老单据状态有一定几率会更改，例如有全部收款，变更为超收款等=;3)The status of the old orders might changes, such as from fully paid to over paid
;您好，关闭=;Hello, close
;1）关闭分仓管理后，默认仓库对应的库存数量会被继续使用=;1)After close the warehouse management, will keep using inventory quantity for default warehouse 
;2）关闭分仓管理后，其他仓库对应的产品库存数量整体被隐藏，不可以再次使用，请在关闭前调入默认仓库=;2)After close the warehouse management, the inventory quantity in other warehouse will be hided and can not be reversed, please sync the data to default warehouse before doing so
;3）关闭分仓管理后，仓库对应的老单子，可以继续查看、编辑和打印=;3)After close the warehouse management, you can keep reviewing, editing and printing the Orders in corresponding warehouse.
;4）关闭分仓管理后，新增单子不可以再次选择仓库=;4)After close the warehouse management, new orders can not choose warehouse again
;5）关闭分仓管理只是隐藏仓库列表，不执行删除操作=;5)Closing the warehouse management is only hiding the list, but not delete it
;您好，关闭单位属于高危操作，在操作前请仔细阅读下述风险提示内容：=;Hello, to close a unit is high risk action, please read the tips of risks below carefully before you proceed:
;1）单位对应的产品属性：原售价、进价信息比例等全部清空（隐藏），其对应产品价格信息全部初始为最小单位对应的价格=;1) The corresponding product properties will cleaned out (Hided), the corresponding price information will switch to minimum unit price
;2）单位对应的老单子，可以正常查看、编辑和打印=;2) The previous order can be reviewed, edited and printed
;3）单位对应的均价会保留最小单位的均价到产品上=;3) The average price will be the minimum unit price, and it will be used on the product also
;4）单位关闭只是隐藏单位，不执行删除操作=;4)To close a unit is only hide it, but not delete it
;系统最高权限者，可以操作所有功能，更改其他角色权限=;The highest position in the system, can use all the function and change the other characters' access right
;拥有所有数据的查看权限=;Have the right to review all the documents
费用权限=Expenses permission
新增费用收入单=New income statement
查看自己费用收入单=Check your own income statement
查看所有费用收入单=Check all income statement
编辑自己费用收入单=Edit your own income statement
编辑所有费用收入单=Edit all income statement
删除自己费用收入单=Delete your own income statement
删除所有费用收入单=Delete all expenses income statement
查看子产品列表=Check sub product list
编辑子产品列表=Edit sub product list
新增加工单=Add in new process order
查看自己加工单=Check your own process order
查看所有加工单=Check all the process order
编辑自己加工单=Edit your own process order
编辑所有加工单=Edit all the process order
删除自己加工单=Delete your own process order
删除所有加工单=Delete all the process order 
删除加工单=Delete process order
查看加工单金额=Check process order amount

images/common/login/loginimg.png=images/en/login/logo.png
images/common/noMessage.png=images/en/messageRemind/nomessage.png
images/common/loadding/ceshi11.gif=images/en/common/loading.gif
images/common/logo.png=images/en/common/cdlogotest.png
images/common/favicon_1.png=images/en/common/shortcut.png
images/common/login/login.jpg=images/en/login/background.jpg
images/common/photo_icon2.png=images/en/common/addimg.png
images/common/detailimg/prodcoloradd_2.png=images/en/common/addcolor.png
images/common/addcode.png=images/en/common/userset.png
images/common/addlogo.png=images/en/common/addlogo.png
images/common/detailimg/prodcoloradd.png=images/en/common/addcolor1.png
'images/common'='images/en'
"images/common"="images/en"
images/common/saleFlow.png=images/en/report/Sales Order.png
images/common/purchaseFlow.png=images/en/report/Purchase Order.png
images/common/proSaleOverView.png=images/en/report/Item Sales Report.png
images/common/sendDet.png=images/en/report/Delivery Reminders.png
images/common/receiveDet.png=images/en/report/Receipt Reminders.png
images/common/saleDebtSum.png=images/en/report/Receivables Summary.png
images/common/purchasePaySum.png=images/en/report/Payables Summary.png
images/common/delivery.png=images/en/report/Delivery Note details.png
images/common/receiving.png=images/en/report/Goods Receipt Details.png
images/common/saleResult.png=images/en/report/Sales Performance Report.png
images/common/inOutYearReport.png=images/en/report/Annual Report.png
images/common/assetIncome.png=images/en/report/Income Statement.png
images/common/assetExpend.png=images/en/report/Expenses Statement.png
images/common/clientReconciliation.png=images/en/report/Customer Reconciliation.png
images/common/vendorReconciliation.png=images/en/report/Vendor Reconciliation.png
images/common/salereturn.png=images/en/report/Sales Return.png
images/common/buyreturn.png=images/en/report/Purchase Return.png
template/privacyPolicy.pdf=template/en/BIZGOPrivacyPolicy(Singapore).pdf
template/userAgreement.pdf=template/en/TermsofService.docx
￥=$
&yen;=$